submission_date,state,tot_cases,conf_cases,prob_cases,new_case,pnew_case,tot_death,conf_death,prob_death,new_death,pnew_death,created_at,consent_cases,consent_deaths
12/28/2021,NC,1635870,1380264,255606,7304,1662,19740,17377,2363,30,4,12/28/2021 12:00:00 AM,Agree,Agree
05/23/2021,NC,983457,847368,136089,626,128,13405,11821,1584,7,1,05/23/2021 12:00:00 AM,Agree,Agree
04/22/2020,NC,7330,7330,0,297,0,293,293,0,20,0,04/22/2020 12:00:00 AM,Agree,Agree
03/10/2022,NC,2619907,2192726,427181,915,210,24609,21461,3148,29,5,03/10/2022 12:00:00 AM,Agree,Agree
06/10/2022,NC,2809536,2343966,465570,4192,755,25436,22167,3269,13,4,06/10/2022 12:00:00 AM,Agree,Agree
07/24/2020,NC,109445,108892,553,2236,55,1921,1919,2,31,0,07/24/2020 12:00:00 AM,Agree,Agree
10/30/2020,NC,271400,259970,11430,2741,453,4700,4594,106,41,3,10/30/2020 12:00:00 AM,Agree,Agree
01/14/2022,NC,2049726,1721214,328512,37874,6669,20630,18132,2498,72,11,01/14/2022 12:00:00 AM,Agree,Agree
09/22/2020,NC,199192,194736,4456,1247,141,3603,3566,37,31,1,09/22/2020 12:00:00 AM,Agree,Agree
11/25/2020,NC,348123,328019,20104,4050,681,5656,5461,195,34,5,11/25/2020 12:00:00 AM,Agree,Agree
10/11/2020,NC,230714,223516,7198,1574,65,4109,4048,61,28,5,10/11/2020 12:00:00 AM,Agree,Agree
02/05/2022,NC,2517535,2113087,404448,9933,2039,22727,19865,2862,132,26,02/05/2022 12:00:00 AM,Agree,Agree
07/12/2021,NC,1007408,864900,142508,533,114,13698,12078,1620,3,0,07/12/2021 12:00:00 AM,Agree,Agree
10/04/2021,NC,1405916,1195829,210087,2216,224,17421,15323,2098,56,6,10/04/2021 12:00:00 AM,Agree,Agree
05/01/2021,NC,959029,828730,130299,1707,415,13129,11596,1533,11,1,05/01/2021 12:00:00 AM,Agree,Agree
07/18/2020,NC,97998,97635,363,2342,34,1770,1768,2,23,0,07/18/2020 12:00:00 AM,Agree,Agree
04/29/2022,NC,2664554,2228017,436537,2421,388,25103,21893,3210,5,0,04/29/2022 12:00:00 AM,Agree,Agree
05/18/2022,NC,2718632,2271445,447187,4833,1049,25228,21995,3233,11,2,05/18/2022 12:00:00 AM,Agree,Agree
11/07/2021,NC,1481814,1256524,225290,1359,179,18655,16420,2235,19,1,11/07/2021 12:00:00 AM,Agree,Agree
04/08/2021,NC,916454,796316,120138,2087,459,12862,11365,1497,16,3,04/08/2021 12:00:00 AM,Agree,Agree
08/31/2022,NC,3128728,2591821,536907,3866,1093,26541,23070,3471,14,2,08/31/2022 12:00:00 AM,Agree,Agree
12/08/2021,NC,1548003,1308630,239373,3295,848,19215,16915,2300,15,0,12/08/2021 12:00:00 AM,Agree,Agree
05/24/2021,NC,983902,847726,136176,445,87,13415,11830,1585,10,1,05/24/2021 12:00:00 AM,Agree,Agree
03/17/2020,NC,39,39,0,6,0,1,1,0,0,0,03/17/2020 12:00:00 AM,Agree,Agree
01/10/2022,NC,1913588,1611281,302307,17781,1808,20350,17891,2459,59,4,01/10/2022 12:00:00 AM,Agree,Agree
09/15/2022,NC,3173670,2625494,548176,3409,841,26730,23227,3503,14,2,09/15/2022 12:00:00 AM,Agree,Agree
11/02/2020,NC,277205,265414,11791,1512,69,4810,4696,114,42,3,11/02/2020 12:00:00 AM,Agree,Agree
07/11/2021,NC,1006875,864481,142394,682,166,13695,12075,1620,4,1,07/11/2021 12:00:00 AM,Agree,Agree
10/03/2022,NC,3210904,2653741,557163,904,182,26853,23332,3521,1,0,10/03/2022 12:00:00 AM,Agree,Agree
12/18/2021,NC,1582967,1336171,246796,4116,913,19460,17131,2329,26,3,12/18/2021 12:00:00 AM,Agree,Agree
07/13/2022,NC,2927184,2435803,491381,5173,1328,25823,22471,3352,9,6,07/13/2022 12:00:00 AM,Agree,Agree
02/19/2021,NC,832128,732640,99488,3187,1066,12046,10670,1376,34,4,02/19/2021 12:00:00 AM,Agree,Agree
04/23/2021,NC,945012,818186,126826,1948,440,13034,11515,1519,14,2,04/23/2021 12:00:00 AM,Agree,Agree
01/11/2021,NC,637560,577066,60494,5772,452,8994,8194,800,91,18,01/11/2021 12:00:00 AM,Agree,Agree
03/22/2022,NC,2626257,2197610,428647,457,130,24834,21656,3178,16,0,03/22/2022 12:00:00 AM,Agree,Agree
08/17/2020,NC,147777,146001,1776,886,30,2592,2586,6,31,0,08/17/2020 12:00:00 AM,Agree,Agree
04/21/2022,NC,2650288,2216573,433715,1852,352,25056,21853,3203,2,1,04/21/2022 12:00:00 AM,Agree,Agree
07/16/2022,NC,2941925,2447178,494747,4858,1075,25872,22512,3360,13,2,07/16/2022 12:00:00 AM,Agree,Agree
04/13/2022,NC,2640234,2208492,431742,1235,240,25011,21816,3195,7,0,04/13/2022 12:00:00 AM,Agree,Agree
01/17/2022,NC,2146411,1807534,338877,22506,1239,20875,18344,2531,79,11,01/17/2022 12:00:00 AM,Agree,Agree
05/06/2020,NC,12912,12912,0,438,0,539,539,0,25,0,05/06/2020 12:00:00 AM,Agree,Agree
09/27/2022,NC,3200882,2645928,554954,1908,579,26836,23316,3520,6,0,09/27/2022 12:00:00 AM,Agree,Agree
08/31/2021,NC,1211872,1033404,178468,6828,1369,15075,13262,1813,61,8,08/31/2021 12:00:00 AM,Agree,Agree
10/15/2021,NC,1439887,1223164,216723,3048,679,17942,15777,2165,41,2,10/15/2021 12:00:00 AM,Agree,Agree
06/12/2021,NC,993971,855156,138815,456,117,13564,11960,1604,6,0,06/12/2021 12:00:00 AM,Agree,Agree
08/26/2022,NC,3114369,2580841,533528,3665,807,26469,23008,3461,9,2,08/26/2022 12:00:00 AM,Agree,Agree
02/28/2021,NC,852659,748761,103898,1724,238,12323,10898,1425,21,1,02/28/2021 12:00:00 AM,Agree,Agree
03/01/2022,NC,2610812,2185842,424970,1179,331,24309,21200,3109,23,2,03/01/2022 12:00:00 AM,Agree,Agree
05/11/2021,NC,971659,838421,133238,994,296,13255,11694,1561,20,4,05/11/2021 12:00:00 AM,Agree,Agree
06/26/2020,NC,59139,59111,28,1604,11,1392,1392,0,17,0,06/26/2020 12:00:00 AM,Agree,Agree
05/13/2021,NC,974275,840391,133884,1296,290,13274,11711,1563,8,0,05/13/2021 12:00:00 AM,Agree,Agree
05/04/2021,NC,962535,831403,131132,1261,366,13163,11622,1541,16,4,05/04/2021 12:00:00 AM,Agree,Agree
05/16/2021,NC,977304,842787,134517,808,160,13315,11746,1569,14,1,05/16/2021 12:00:00 AM,Agree,Agree
06/04/2020,NC,32122,32120,2,1209,0,1066,1066,0,19,0,06/04/2020 12:00:00 AM,Agree,Agree
08/12/2021,NC,1094513,934818,159695,6643,1153,14105,12428,1677,31,6,08/12/2021 12:00:00 AM,Agree,Agree
11/15/2020,NC,312954,297234,15720,2773,167,5268,5114,154,34,2,11/15/2020 12:00:00 AM,Agree,Agree
03/28/2021,NC,899055,783286,115769,1490,336,12742,11265,1477,13,1,03/28/2021 12:00:00 AM,Agree,Agree
02/06/2020,NC,0,,,0,,0,,,0,,03/26/2020 04:22:39 PM,Agree,Agree
05/30/2021,NC,988247,850941,137306,470,122,13466,11875,1591,8,1,05/30/2021 12:00:00 AM,Agree,Agree
07/09/2022,NC,2911897,2423850,488047,4777,1087,25782,22444,3338,9,2,07/09/2022 12:00:00 AM,Agree,Agree
06/28/2021,NC,999830,859345,140485,226,53,13639,12025,1614,3,0,06/28/2021 12:00:00 AM,Agree,Agree
11/03/2020,NC,279501,267369,12132,2296,341,4850,4730,120,40,6,11/03/2020 12:00:00 AM,Agree,Agree
10/26/2020,NC,261469,251271,10198,1757,73,4551,4455,96,33,4,10/26/2020 12:00:00 AM,Agree,Agree
09/07/2021,NC,1260073,1074469,185604,3825,473,15591,13718,1873,68,8,09/07/2021 12:00:00 AM,Agree,Agree
11/09/2021,NC,1484312,1258445,225867,1495,468,18693,16457,2236,22,0,11/09/2021 12:00:00 AM,Agree,Agree
06/02/2020,NC,30094,30093,1,629,0,1026,1026,0,17,0,06/02/2020 12:00:00 AM,Agree,Agree
01/13/2022,NC,2011852,1690009,321843,39001,6438,20558,18071,2487,66,8,01/13/2022 12:00:00 AM,Agree,Agree
09/15/2021,NC,1313772,1118344,195428,6900,1474,16191,14240,1951,81,11,09/15/2021 12:00:00 AM,Agree,Agree
05/26/2020,NC,24306,24305,1,463,0,877,877,0,32,0,05/26/2020 12:00:00 AM,Agree,Agree
05/08/2021,NC,968862,836273,132589,1378,257,13216,11665,1551,14,5,05/08/2021 12:00:00 AM,Agree,Agree
11/04/2020,NC,281995,269547,12448,2494,316,4881,4761,120,31,0,11/04/2020 12:00:00 AM,Agree,Agree
07/31/2021,NC,1043939,893499,150440,3621,722,13859,12218,1641,14,1,07/31/2021 12:00:00 AM,Agree,Agree
03/26/2020,NC,661,661,0,117,0,4,4,0,1,0,03/26/2020 12:00:00 AM,Agree,Agree
03/30/2021,NC,901620,785110,116510,1553,462,12761,11278,1483,9,1,03/30/2021 12:00:00 AM,Agree,Agree
05/05/2022,NC,2677250,2238111,439139,3145,621,25139,21920,3219,6,1,05/05/2022 12:00:00 AM,Agree,Agree
04/13/2020,NC,4833,4833,0,299,0,125,125,0,18,0,04/13/2020 12:00:00 AM,Agree,Agree
03/03/2020,NC,1,1,0,1,0,0,0,0,0,0,03/03/2020 12:00:00 AM,Agree,Agree
07/03/2021,NC,1002235,861068,141167,520,136,13662,12047,1615,5,0,07/03/2021 12:00:00 AM,Agree,Agree
05/07/2022,NC,2683029,2242625,440404,2780,593,25146,21927,3219,2,0,05/07/2022 12:00:00 AM,Agree,Agree
01/19/2022,NC,2189473,1842016,347457,24332,5797,21036,18482,2554,97,12,01/19/2022 12:00:00 AM,Agree,Agree
03/25/2022,NC,2628497,2199263,429234,897,233,24866,21685,3181,8,0,03/25/2022 12:00:00 AM,Agree,Agree
05/29/2020,NC,26722,26721,1,1140,0,949,949,0,19,0,05/29/2020 12:00:00 AM,Agree,Agree
02/10/2022,NC,2552326,2140813,411513,7621,1666,23183,20250,2933,79,12,02/10/2022 12:00:00 AM,Agree,Agree
07/28/2020,NC,116861,116155,706,2028,64,2019,2016,3,32,1,07/28/2020 12:00:00 AM,Agree,Agree
12/04/2020,NC,387025,361826,25199,6062,704,6024,5774,250,44,10,12/04/2020 12:00:00 AM,Agree,Agree
09/16/2020,NC,191206,187248,3958,1388,126,3430,3401,29,23,0,09/16/2020 12:00:00 AM,Agree,Agree
08/21/2022,NC,3097819,2568259,529560,2443,379,26404,22950,3454,18,5,08/21/2022 12:00:00 AM,Agree,Agree
01/20/2022,NC,2225937,1871757,354180,36464,6723,21118,18549,2569,82,15,01/20/2022 12:00:00 AM,Agree,Agree
10/20/2021,NC,1450092,1231362,218730,2453,555,18160,15968,2192,52,7,10/20/2021 12:00:00 AM,Agree,Agree
09/07/2020,NC,180297,177045,3252,818,17,3182,3165,17,27,1,09/07/2020 12:00:00 AM,Agree,Agree
07/29/2020,NC,118468,117702,766,1607,60,2044,2041,3,25,0,07/29/2020 12:00:00 AM,Agree,Agree
11/08/2020,NC,292436,279047,13389,2197,121,5014,4884,130,32,3,11/08/2020 12:00:00 AM,Agree,Agree
08/07/2021,NC,1071232,915796,155436,5029,848,13987,12326,1661,18,1,08/07/2021 12:00:00 AM,Agree,Agree
09/05/2021,NC,1251057,1066304,184753,6274,467,15458,13595,1863,74,12,09/05/2021 12:00:00 AM,Agree,Agree
05/10/2022,NC,2689545,2247923,441622,2481,620,25167,21946,3221,10,1,05/10/2022 12:00:00 AM,Agree,Agree
04/19/2021,NC,937296,812329,124967,1156,246,12982,11469,1513,10,2,04/19/2021 12:00:00 AM,Agree,Agree
12/19/2020,NC,478074,440463,37611,6403,1058,6995,6571,424,74,11,12/19/2020 12:00:00 AM,Agree,Agree
12/01/2020,NC,369664,346861,22803,4304,1089,5899,5670,229,37,8,12/01/2020 12:00:00 AM,Agree,Agree
08/06/2021,NC,1066203,911615,154588,4734,1002,13969,12309,1660,28,7,08/06/2021 12:00:00 AM,Agree,Agree
04/17/2020,NC,5876,5876,0,393,0,207,207,0,26,0,04/17/2020 12:00:00 AM,Agree,Agree
10/12/2021,NC,1430443,1215688,214755,2414,617,17808,15654,2154,44,8,10/12/2021 12:00:00 AM,Agree,Agree
03/20/2020,NC,153,153,0,49,0,1,1,0,0,0,03/20/2020 12:00:00 AM,Agree,Agree
07/04/2021,NC,1002688,861401,141287,453,120,13664,12049,1615,2,0,07/04/2021 12:00:00 AM,Agree,Agree
11/26/2020,NC,352758,332024,20734,4635,630,5693,5494,199,37,4,11/26/2020 12:00:00 AM,Agree,Agree
12/30/2021,NC,1670803,1408671,262132,19877,3512,19796,17422,2374,23,6,12/30/2021 12:00:00 AM,Agree,Agree
10/18/2020,NC,245046,236430,8616,1710,95,4304,4229,75,35,3,10/18/2020 12:00:00 AM,Agree,Agree
09/13/2022,NC,3166669,2620312,546357,2907,877,26703,23205,3498,20,5,09/13/2022 12:00:00 AM,Agree,Agree
02/20/2020,NC,0,,,0,,0,,,0,,03/26/2020 04:22:39 PM,Agree,Agree
04/22/2021,NC,943064,816678,126386,2213,478,13020,11503,1517,15,1,04/22/2021 12:00:00 AM,Agree,Agree
12/28/2020,NC,524115,480493,43622,4176,526,7647,7103,544,80,13,12/28/2020 12:00:00 AM,Agree,Agree
02/17/2021,NC,825658,727968,97690,3242,754,11970,10605,1365,40,3,02/17/2021 12:00:00 AM,Agree,Agree
04/01/2021,NC,905585,788008,117577,2085,519,12788,11302,1486,9,0,04/01/2021 12:00:00 AM,Agree,Agree
03/03/2022,NC,2613774,2188064,425710,1438,344,24383,21262,3121,34,4,03/03/2022 12:00:00 AM,Agree,Agree
01/28/2021,NC,743603,665312,78291,6414,1034,10718,9559,1159,111,20,01/28/2021 12:00:00 AM,Agree,Agree
04/08/2020,NC,3450,3450,0,300,0,72,72,0,9,0,04/08/2020 12:00:00 AM,Agree,Agree
07/23/2021,NC,1021919,875859,146060,2266,442,13763,12134,1629,11,1,07/23/2021 12:00:00 AM,Agree,Agree
01/19/2021,NC,691082,621658,69424,5382,1741,9835,8865,970,111,20,01/19/2021 12:00:00 AM,Agree,Agree
03/28/2022,NC,2629657,2200126,429531,254,35,24898,21714,3184,10,2,03/28/2022 12:00:00 AM,Agree,Agree
09/09/2020,NC,182183,178786,3397,1063,123,3238,3219,19,24,1,09/09/2020 12:00:00 AM,Agree,Agree
05/23/2020,NC,22719,22718,1,944,0,804,804,0,20,0,05/23/2020 12:00:00 AM,Agree,Agree
04/20/2020,NC,6815,6815,0,292,0,255,255,0,15,0,04/20/2020 12:00:00 AM,Agree,Agree
04/05/2021,NC,911387,792460,118927,975,220,12833,11340,1493,8,3,04/05/2021 12:00:00 AM,Agree,Agree
04/20/2022,NC,2648436,2215073,433363,1524,342,25054,21852,3202,5,1,04/20/2022 12:00:00 AM,Agree,Agree
10/25/2021,NC,1459470,1238935,220535,1172,160,18324,16120,2204,33,0,10/25/2021 12:00:00 AM,Agree,Agree
09/20/2020,NC,197124,192829,4295,1136,28,3544,3509,35,18,1,09/20/2020 12:00:00 AM,Agree,Agree
10/19/2020,NC,246585,237902,8683,1539,67,4322,4245,77,18,2,10/19/2020 12:00:00 AM,Agree,Agree
10/14/2021,NC,1436839,1220795,216044,3274,632,17901,15738,2163,38,5,10/14/2021 12:00:00 AM,Agree,Agree
06/29/2022,NC,2873485,2394260,479225,4610,1170,25655,22342,3313,11,2,06/29/2022 12:00:00 AM,Agree,Agree
05/30/2022,NC,2767610,2310882,456728,2519,375,25321,22072,3249,9,3,05/30/2022 12:00:00 AM,Agree,Agree
05/13/2022,NC,2701243,2257413,443830,3945,749,25189,21961,3228,4,2,05/13/2022 12:00:00 AM,Agree,Agree
10/01/2021,NC,1395981,1187200,208781,4271,750,17245,15163,2082,57,5,10/01/2021 12:00:00 AM,Agree,Agree
11/12/2020,NC,303026,288404,14622,3281,315,5157,5015,142,41,3,11/12/2020 12:00:00 AM,Agree,Agree
09/10/2020,NC,183446,179963,3483,1263,86,3259,3239,20,21,1,09/10/2020 12:00:00 AM,Agree,Agree
06/19/2022,NC,2839317,2367769,471548,2768,384,25539,22248,3291,8,2,06/19/2022 12:00:00 AM,Agree,Agree
10/02/2021,NC,1400731,1191212,209519,4750,738,17297,15210,2087,52,5,10/02/2021 12:00:00 AM,Agree,Agree
08/16/2021,NC,1114955,952250,162705,3544,319,14248,12546,1702,41,6,08/16/2021 12:00:00 AM,Agree,Agree
01/03/2022,NC,1738235,1465911,272324,12512,1214,19937,17542,2395,50,8,01/03/2022 12:00:00 AM,Agree,Agree
08/22/2021,NC,1151593,982648,168945,5487,457,14526,12778,1748,45,9,08/22/2021 12:00:00 AM,Agree,Agree
11/05/2021,NC,1478758,1253976,224782,1823,391,18615,16385,2230,26,3,11/05/2021 12:00:00 AM,Agree,Agree
05/06/2022,NC,2680249,2240438,439811,2999,672,25144,21925,3219,5,0,05/06/2022 12:00:00 AM,Agree,Agree
08/17/2021,NC,1119768,955910,163858,4813,1153,14291,12578,1713,43,11,08/17/2021 12:00:00 AM,Agree,Agree
07/12/2022,NC,2922011,2431958,490053,3909,1076,25814,22468,3346,7,3,07/12/2022 12:00:00 AM,Agree,Agree
03/24/2021,NC,891641,777560,114081,1891,505,12699,11227,1472,14,1,03/24/2021 12:00:00 AM,Agree,Agree
07/28/2022,NC,2999113,2490961,508152,5761,1418,26043,22650,3393,15,3,07/28/2022 12:00:00 AM,Agree,Agree
07/17/2022,NC,2945477,2450189,495288,3552,541,25880,22520,3360,8,0,07/17/2022 12:00:00 AM,Agree,Agree
08/18/2022,NC,3087913,2560395,527518,3918,887,26357,22915,3442,18,2,08/18/2022 12:00:00 AM,Agree,Agree
06/03/2020,NC,30913,30911,2,819,1,1047,1047,0,21,0,06/03/2020 12:00:00 AM,Agree,Agree
07/25/2020,NC,111477,110874,603,2032,50,1943,1941,2,22,0,07/25/2020 12:00:00 AM,Agree,Agree
08/08/2021,NC,1074994,919074,155920,3762,484,14005,12342,1663,18,2,08/08/2021 12:00:00 AM,Agree,Agree
06/09/2021,NC,992556,854130,138426,462,121,13538,11938,1600,0,0,06/09/2021 12:00:00 AM,Agree,Agree
07/08/2021,NC,1004734,862883,141851,784,255,13681,12064,1617,4,1,07/08/2021 12:00:00 AM,Agree,Agree
07/15/2022,NC,2937067,2443395,493672,4984,1210,25859,22501,3358,16,1,07/15/2022 12:00:00 AM,Agree,Agree
05/06/2021,NC,965960,833988,131972,1725,398,13194,11648,1546,14,2,05/06/2021 12:00:00 AM,Agree,Agree
07/21/2021,NC,1017740,872574,145166,1735,460,13744,12117,1627,6,0,07/21/2021 12:00:00 AM,Agree,Agree
09/12/2021,NC,1295793,1103619,192174,6135,553,15943,14019,1924,66,6,09/12/2021 12:00:00 AM,Agree,Agree
12/31/2020,NC,547302,498945,48357,10283,1535,7926,7333,593,94,19,12/31/2020 12:00:00 AM,Agree,Agree
01/23/2021,NC,718115,644168,73947,6662,1017,10262,9203,1059,92,20,01/23/2021 12:00:00 AM,Agree,Agree
06/26/2022,NC,2863442,2386733,476709,2971,433,25623,22320,3303,9,1,06/26/2022 12:00:00 AM,Agree,Agree
03/16/2021,NC,878422,767641,110781,1548,605,12591,11133,1458,9,0,03/16/2021 12:00:00 AM,Agree,Agree
12/18/2020,NC,471671,435118,36553,7723,1034,6921,6508,413,68,18,12/18/2020 12:00:00 AM,Agree,Agree
04/15/2020,NC,5189,5189,0,171,0,158,158,0,16,0,04/15/2020 12:00:00 AM,Agree,Agree
07/06/2022,NC,2896966,2412562,484404,2850,958,25745,22414,3331,14,3,07/06/2022 12:00:00 AM,Agree,Agree
06/30/2021,NC,1000695,859928,140767,449,142,13645,12031,1614,4,0,06/30/2021 12:00:00 AM,Agree,Agree
04/27/2021,NC,951330,822847,128483,1424,434,13079,11553,1526,10,1,04/27/2021 12:00:00 AM,Agree,Agree
08/30/2021,NC,1205044,1027945,177099,4687,401,15014,13209,1805,70,6,08/30/2021 12:00:00 AM,Agree,Agree
02/14/2021,NC,818194,722349,95845,2460,261,11843,10489,1354,53,8,02/14/2021 12:00:00 AM,Agree,Agree
10/28/2021,NC,1465552,1243570,221982,2200,427,18411,16196,2215,25,5,10/28/2021 12:00:00 AM,Agree,Agree
09/29/2020,NC,208933,203692,5241,1351,204,3802,3759,43,32,1,09/29/2020 12:00:00 AM,Agree,Agree
05/04/2020,NC,12158,12158,0,239,0,496,496,0,19,0,05/04/2020 12:00:00 AM,Agree,Agree
10/19/2021,NC,1447639,1229464,218175,1860,517,18108,15923,2185,40,5,10/19/2021 12:00:00 AM,Agree,Agree
10/28/2020,NC,265842,255115,10727,2328,276,4609,4510,99,28,0,10/28/2020 12:00:00 AM,Agree,Agree
02/19/2020,NC,0,,,0,,0,,,0,,03/26/2020 04:22:39 PM,Agree,Agree
06/15/2020,NC,45240,45232,8,1081,0,1241,1241,0,23,0,06/15/2020 12:00:00 AM,Agree,Agree
07/17/2021,NC,1012907,868907,144000,1228,322,13724,12099,1625,7,2,07/17/2021 12:00:00 AM,Agree,Agree
04/24/2022,NC,2655116,2220521,434595,1250,181,25069,21862,3207,7,2,04/24/2022 12:00:00 AM,Agree,Agree
05/17/2021,NC,977805,843175,134630,501,113,13333,11758,1575,18,6,05/17/2021 12:00:00 AM,Agree,Agree
10/07/2021,NC,1416224,1203759,212465,3861,731,17580,15461,2119,43,4,10/07/2021 12:00:00 AM,Agree,Agree
03/02/2022,NC,2612336,2186970,425366,1524,396,24349,21232,3117,40,8,03/02/2022 12:00:00 AM,Agree,Agree
08/23/2020,NC,157734,155512,2222,1516,45,2762,2754,8,29,1,08/23/2020 12:00:00 AM,Agree,Agree
07/31/2022,NC,3014214,2502941,511273,3775,594,26086,22685,3401,15,0,07/31/2022 12:00:00 AM,Agree,Agree
03/29/2022,NC,2630197,2200498,429699,540,168,24908,21722,3186,10,2,03/29/2022 12:00:00 AM,Agree,Agree
08/08/2022,NC,3048950,2530378,518572,2773,422,26201,22786,3415,14,3,08/08/2022 12:00:00 AM,Agree,Agree
02/29/2020,NC,0,,,0,,0,,,0,,03/26/2020 04:22:39 PM,Agree,Agree
07/05/2022,NC,2894116,2410670,483446,2004,401,25731,22403,3328,14,3,07/05/2022 12:00:00 AM,Agree,Agree
08/11/2020,NC,139260,137861,1399,1320,72,2433,2428,5,33,0,08/11/2020 12:00:00 AM,Agree,Agree
03/05/2021,NC,861743,755573,106170,1939,433,12424,10987,1437,17,2,03/05/2021 12:00:00 AM,Agree,Agree
02/15/2022,NC,2574890,2158420,416470,3304,1030,23589,20584,3005,61,13,02/15/2022 12:00:00 AM,Agree,Agree
08/16/2022,NC,3079974,2554431,525543,3336,930,26326,22888,3438,17,4,08/16/2022 12:00:00 AM,Agree,Agree
05/20/2021,NC,980808,845419,135389,1068,256,13373,11793,1580,18,3,05/20/2021 12:00:00 AM,Agree,Agree
07/07/2021,NC,1003950,862354,141596,676,200,13677,12061,1616,8,0,07/07/2021 12:00:00 AM,Agree,Agree
04/07/2022,NC,2635272,2204469,430803,816,155,24972,21781,3191,9,0,04/07/2022 12:00:00 AM,Agree,Agree
06/17/2020,NC,47046,47038,8,854,0,1258,1258,0,9,0,06/17/2020 12:00:00 AM,Agree,Agree
03/04/2021,NC,859804,754067,105737,2329,527,12407,10972,1435,21,2,03/04/2021 12:00:00 AM,Agree,Agree
11/29/2021,NC,1520795,1287515,233280,1609,242,19053,16775,2278,16,1,11/29/2021 12:00:00 AM,Agree,Agree
08/01/2022,NC,3017162,2505465,511697,2948,424,26105,22700,3405,19,4,08/01/2022 12:00:00 AM,Agree,Agree
08/15/2022,NC,3076638,2552025,524613,2265,299,26309,22875,3434,16,2,08/15/2022 12:00:00 AM,Agree,Agree
12/16/2021,NC,1574806,1329815,244991,4183,823,19408,17083,2325,24,3,12/16/2021 12:00:00 AM,Agree,Agree
05/11/2020,NC,15264,15264,0,267,0,625,625,0,25,0,05/11/2020 12:00:00 AM,Agree,Agree
03/06/2021,NC,863488,756891,106597,1745,427,12440,11001,1439,16,2,03/06/2021 12:00:00 AM,Agree,Agree
03/15/2021,NC,876874,766698,110176,1101,275,12582,11124,1458,14,1,03/15/2021 12:00:00 AM,Agree,Agree
03/03/2021,NC,857475,752265,105210,2151,556,12386,10953,1433,21,4,03/03/2021 12:00:00 AM,Agree,Agree
03/21/2021,NC,887348,774530,112818,1385,234,12667,11199,1468,15,1,03/21/2021 12:00:00 AM,Agree,Agree
08/15/2021,NC,1111411,949025,162386,4881,546,14207,12511,1696,34,8,08/15/2021 12:00:00 AM,Agree,Agree
02/13/2021,NC,815734,720150,95584,3609,690,11790,10444,1346,55,6,02/13/2021 12:00:00 AM,Agree,Agree
08/04/2022,NC,3032456,2516919,515537,5589,1243,26144,22735,3409,14,1,08/04/2022 12:00:00 AM,Agree,Agree
09/01/2022,NC,3132397,2594536,537861,3669,954,26556,23080,3476,15,5,09/01/2022 12:00:00 AM,Agree,Agree
03/05/2020,NC,1,1,0,0,0,0,0,0,0,0,03/05/2020 12:00:00 AM,Agree,Agree
05/03/2021,NC,961274,830508,130766,912,200,13147,11610,1537,12,2,05/03/2021 12:00:00 AM,Agree,Agree
02/28/2022,NC,2609633,2184994,424639,682,107,24286,21179,3107,36,4,02/28/2022 12:00:00 AM,Agree,Agree
03/11/2022,NC,2620753,2193335,427418,846,237,24640,21486,3154,31,6,03/11/2022 12:00:00 AM,Agree,Agree
07/24/2022,NC,2979180,2476194,502986,4204,735,25991,22609,3382,17,3,07/24/2022 12:00:00 AM,Agree,Agree
01/06/2022,NC,1809214,1522010,287204,29231,5459,20097,17675,2422,64,11,01/06/2022 12:00:00 AM,Agree,Agree
03/20/2021,NC,885963,773379,112584,1817,441,12652,11185,1467,18,2,03/20/2021 12:00:00 AM,Agree,Agree
07/10/2022,NC,2915581,2426982,488599,3684,552,25794,22455,3339,12,1,07/10/2022 12:00:00 AM,Agree,Agree
02/06/2022,NC,2524337,2118943,405394,6802,946,22818,19943,2875,91,13,02/06/2022 12:00:00 AM,Agree,Agree
03/18/2022,NC,2624705,2196400,428305,667,127,24768,21594,3174,23,3,03/18/2022 12:00:00 AM,Agree,Agree
11/27/2020,NC,356135,335260,20875,3377,141,5735,5529,206,42,7,11/27/2020 12:00:00 AM,Agree,Agree
05/29/2022,NC,2765091,2308738,456353,3388,496,25312,22066,3246,10,0,05/29/2022 12:00:00 AM,Agree,Agree
11/21/2021,NC,1507427,1276858,230569,1637,236,18899,16634,2265,19,1,11/21/2021 12:00:00 AM,Agree,Agree
07/05/2021,NC,1002991,861637,141354,303,67,13667,12051,1616,3,1,07/05/2021 12:00:00 AM,Agree,Agree
11/23/2021,NC,1510468,1279265,231203,1745,468,18937,16672,2265,18,0,11/23/2021 12:00:00 AM,Agree,Agree
06/27/2021,NC,999604,859172,140432,330,81,13636,12022,1614,1,0,06/27/2021 12:00:00 AM,Agree,Agree
03/16/2020,NC,33,33,0,1,0,1,1,0,0,0,03/16/2020 12:00:00 AM,Agree,Agree
05/22/2021,NC,982831,846870,135961,1054,353,13398,11815,1583,10,1,05/22/2021 12:00:00 AM,Agree,Agree
04/07/2021,NC,914367,794688,119679,1841,520,12846,11352,1494,3,0,04/07/2021 12:00:00 AM,Agree,Agree
01/15/2021,NC,667971,602194,65777,9063,1186,9409,8522,887,101,22,01/15/2021 12:00:00 AM,Agree,Agree
11/11/2020,NC,299745,285438,14307,3124,380,5116,4977,139,30,2,11/11/2020 12:00:00 AM,Agree,Agree
03/06/2020,NC,1,1,0,0,0,0,0,0,0,0,03/06/2020 12:00:00 AM,Agree,Agree
09/05/2022,NC,3143221,2602961,540260,1701,275,26603,23118,3485,13,2,09/05/2022 12:00:00 AM,Agree,Agree
06/01/2021,NC,988846,851390,137456,289,86,13484,11892,1592,11,1,06/01/2021 12:00:00 AM,Agree,Agree
09/24/2022,NC,3196422,2642509,553913,2504,637,26816,23300,3516,10,3,09/24/2022 12:00:00 AM,Agree,Agree
04/04/2021,NC,910412,791705,118707,1217,300,12825,11335,1490,15,2,04/04/2021 12:00:00 AM,Agree,Agree
11/30/2020,NC,365360,343646,21714,2405,259,5862,5641,221,35,4,11/30/2020 12:00:00 AM,Agree,Agree
06/12/2022,NC,2816225,2349438,466787,2738,397,25463,22185,3278,10,2,06/12/2022 12:00:00 AM,Agree,Agree
04/18/2020,NC,6169,6169,0,293,0,221,221,0,14,0,04/18/2020 12:00:00 AM,Agree,Agree
10/16/2020,NC,241173,232865,8308,2699,296,4240,4170,70,27,0,10/16/2020 12:00:00 AM,Agree,Agree
08/02/2020,NC,126104,125112,992,1388,25,2172,2169,3,41,0,08/02/2020 12:00:00 AM,Agree,Agree
06/15/2021,NC,994833,855816,139017,327,96,13581,11976,1605,7,1,06/15/2021 12:00:00 AM,Agree,Agree
04/25/2021,NC,948886,821049,127837,1465,267,13059,11536,1523,14,4,04/25/2021 12:00:00 AM,Agree,Agree
06/05/2020,NC,33375,33371,4,1253,2,1076,1076,0,10,0,06/05/2020 12:00:00 AM,Agree,Agree
07/21/2022,NC,2964095,2464354,499741,5944,1292,25940,22569,3371,13,2,07/21/2022 12:00:00 AM,Agree,Agree
02/03/2020,NC,0,,,0,,0,,,0,,03/26/2020 04:22:39 PM,Agree,Agree
04/24/2021,NC,947421,819851,127570,2409,744,13045,11526,1519,11,0,04/24/2021 12:00:00 AM,Agree,Agree
12/24/2020,NC,507681,465592,42089,6958,1006,7344,6851,493,66,19,12/24/2020 12:00:00 AM,Agree,Agree
12/27/2020,NC,519939,476843,43096,2777,438,7567,7036,531,72,11,12/27/2020 12:00:00 AM,Agree,Agree
06/05/2022,NC,2791310,2329580,461730,3283,527,25387,22129,3258,8,0,06/05/2022 12:00:00 AM,Agree,Agree
07/25/2021,NC,1025890,879072,146818,1758,299,13784,12152,1632,11,2,07/25/2021 12:00:00 AM,Agree,Agree
12/10/2020,NC,421909,392469,29440,7103,876,6349,6051,298,67,11,12/10/2020 12:00:00 AM,Agree,Agree
09/09/2021,NC,1273255,1084434,188821,7811,1697,15729,13833,1896,69,13,09/09/2021 12:00:00 AM,Agree,Agree
10/02/2020,NC,214556,208781,5775,1994,176,3872,3827,45,18,0,10/02/2020 12:00:00 AM,Agree,Agree
02/03/2022,NC,2496277,2096243,400034,13784,2573,22476,19662,2814,83,18,02/03/2022 12:00:00 AM,Agree,Agree
03/17/2021,NC,880203,768952,111251,1781,470,12602,11142,1460,11,2,03/17/2021 12:00:00 AM,Agree,Agree
01/29/2022,NC,2439596,2050421,389175,19808,3165,22039,19313,2726,120,17,01/29/2022 12:00:00 AM,Agree,Agree
05/28/2021,NC,987098,850055,137043,730,196,13450,11862,1588,6,0,05/28/2021 12:00:00 AM,Agree,Agree
06/04/2022,NC,2788027,2326824,461203,4457,880,25379,22121,3258,7,0,06/04/2022 12:00:00 AM,Agree,Agree
06/22/2021,NC,997502,857739,139763,325,110,13610,11998,1612,3,1,06/22/2021 12:00:00 AM,Agree,Agree
12/22/2020,NC,493854,454043,39811,5403,1348,7199,6745,454,75,9,12/22/2020 12:00:00 AM,Agree,Agree
06/16/2022,NC,2828966,2359358,469608,3901,850,25509,22226,3283,4,0,06/16/2022 12:00:00 AM,Agree,Agree
06/13/2020,NC,42813,42807,6,1493,0,1197,1197,0,12,0,06/13/2020 12:00:00 AM,Agree,Agree
04/28/2022,NC,2662133,2225984,436149,2061,513,25098,21888,3210,4,0,04/28/2022 12:00:00 AM,Agree,Agree
07/03/2022,NC,2889829,2407138,482691,3159,465,25706,22383,3323,19,2,07/03/2022 12:00:00 AM,Agree,Agree
04/18/2022,NC,2645973,2213130,432843,684,101,25044,21845,3199,1,0,04/18/2022 12:00:00 AM,Agree,Agree
02/02/2022,NC,2482493,2085032,397461,13833,3086,22393,19597,2796,75,15,02/02/2022 12:00:00 AM,Agree,Agree
08/14/2020,NC,143983,142322,1661,1599,77,2518,2513,5,24,0,08/14/2020 12:00:00 AM,Agree,Agree
02/06/2021,NC,791203,700455,90748,4481,817,11393,10123,1270,56,8,02/06/2021 12:00:00 AM,Agree,Agree
11/18/2021,NC,1501239,1271855,229384,2341,516,18840,16583,2257,19,1,11/18/2021 12:00:00 AM,Agree,Agree
03/11/2021,NC,870929,762285,108644,1897,473,12530,11076,1454,18,1,03/11/2021 12:00:00 AM,Agree,Agree
07/29/2022,NC,3004989,2495635,509354,5876,1202,26059,22661,3398,16,5,07/29/2022 12:00:00 AM,Agree,Agree
02/13/2020,NC,0,,,0,,0,,,0,,03/26/2020 04:22:39 PM,Agree,Agree
08/06/2022,NC,3042661,2524956,517705,4930,1060,26170,22758,3412,11,2,08/06/2022 12:00:00 AM,Agree,Agree
05/24/2020,NC,23287,23286,1,568,0,826,826,0,22,0,05/24/2020 12:00:00 AM,Agree,Agree
05/01/2022,NC,2668229,2231035,437194,1517,261,25110,21897,3213,5,2,05/01/2022 12:00:00 AM,Agree,Agree
08/27/2022,NC,3117689,2583355,534334,3320,806,26490,23026,3464,21,3,08/27/2022 12:00:00 AM,Agree,Agree
05/26/2021,NC,985488,848824,136664,875,265,13436,11848,1588,13,1,05/26/2021 12:00:00 AM,Agree,Agree
05/12/2021,NC,972979,839385,133594,1320,356,13266,11703,1563,11,2,05/12/2021 12:00:00 AM,Agree,Agree
04/08/2022,NC,2636119,2205122,430997,847,194,24982,21790,3192,10,1,04/08/2022 12:00:00 AM,Agree,Agree
07/24/2021,NC,1024132,877613,146519,2213,459,13773,12143,1630,10,1,07/24/2021 12:00:00 AM,Agree,Agree
09/06/2021,NC,1256248,1071117,185131,5191,378,15523,13658,1865,65,2,09/06/2021 12:00:00 AM,Agree,Agree
11/03/2021,NC,1474932,1251057,223875,1876,450,18569,16343,2226,27,4,11/03/2021 12:00:00 AM,Agree,Agree
03/18/2021,NC,882174,770482,111692,1971,441,12616,11154,1462,14,2,03/18/2021 12:00:00 AM,Agree,Agree
10/23/2021,NC,1456712,1236552,220160,1928,424,18258,16058,2200,36,3,10/23/2021 12:00:00 AM,Agree,Agree
09/30/2022,NC,3207383,2650928,556455,1866,420,26849,23328,3521,3,0,09/30/2022 12:00:00 AM,Agree,Agree
03/12/2022,NC,2621523,2193923,427600,770,182,24657,21498,3159,17,5,03/12/2022 12:00:00 AM,Agree,Agree
10/01/2020,NC,212562,206963,5599,2229,199,3854,3809,45,20,0,10/01/2020 12:00:00 AM,Agree,Agree
01/29/2020,NC,0,,,0,,0,,,0,,03/26/2020 04:22:39 PM,Agree,Agree
08/10/2020,NC,137940,136613,1327,790,9,2400,2395,5,35,0,08/10/2020 12:00:00 AM,Agree,Agree
09/02/2020,NC,172990,170025,2965,1325,110,3040,3028,12,31,0,09/02/2020 12:00:00 AM,Agree,Agree
01/12/2022,NC,1972851,1657446,315405,32888,7051,20492,18013,2479,71,14,01/12/2022 12:00:00 AM,Agree,Agree
09/18/2022,NC,3181858,2631657,550201,1942,349,26752,23247,3505,10,1,09/18/2022 12:00:00 AM,Agree,Agree
02/23/2020,NC,0,,,0,,0,,,0,,03/26/2020 04:22:39 PM,Agree,Agree
07/18/2022,NC,2948148,2452416,495732,2671,444,25897,22532,3365,17,5,07/18/2022 12:00:00 AM,Agree,Agree
06/07/2021,NC,991712,853513,138199,273,62,13533,11935,1598,11,0,06/07/2021 12:00:00 AM,Agree,Agree
06/20/2020,NC,51493,51481,12,1476,3,1304,1304,0,17,0,06/20/2020 12:00:00 AM,Agree,Agree
01/28/2022,NC,2419788,2033778,386010,21518,3221,21919,19210,2709,108,21,01/28/2022 12:00:00 AM,Agree,Agree
06/24/2022,NC,2856443,2381048,475395,4041,859,25602,22302,3300,22,2,06/24/2022 12:00:00 AM,Agree,Agree
01/18/2022,NC,2165141,1823481,341660,18730,2783,20939,18397,2542,64,11,01/18/2022 12:00:00 AM,Agree,Agree
03/10/2021,NC,869032,760861,108171,1832,550,12512,11059,1453,21,4,03/10/2021 12:00:00 AM,Agree,Agree
03/28/2020,NC,964,964,0,173,0,6,6,0,1,0,03/28/2020 12:00:00 AM,Agree,Agree
07/11/2022,NC,2918102,2429125,488977,2521,378,25807,22464,3343,13,4,07/11/2022 12:00:00 AM,Agree,Agree
04/14/2022,NC,2641666,2209560,432106,1432,364,25020,21822,3198,9,3,04/14/2022 12:00:00 AM,Agree,Agree
05/26/2022,NC,2752761,2298721,454040,4986,989,25286,22045,3241,13,1,05/26/2022 12:00:00 AM,Agree,Agree
06/21/2020,NC,52770,52758,12,1277,0,1316,1316,0,12,0,06/21/2020 12:00:00 AM,Agree,Agree
02/02/2020,NC,0,,,0,,0,,,0,,03/26/2020 04:22:39 PM,Agree,Agree
03/14/2022,NC,2622260,2194534,427726,348,61,24689,21526,3163,15,3,03/14/2022 12:00:00 AM,Agree,Agree
09/17/2021,NC,1328853,1131141,197712,7209,1068,16344,14366,1978,80,14,09/17/2021 12:00:00 AM,Agree,Agree
10/24/2020,NC,257930,247888,10042,2403,256,4481,4395,86,22,1,10/24/2020 12:00:00 AM,Agree,Agree
12/07/2020,NC,402955,376281,26674,4249,284,6174,5904,270,51,11,12/07/2020 12:00:00 AM,Agree,Agree
08/19/2020,NC,150402,148457,1945,1356,78,2664,2657,7,40,0,08/19/2020 12:00:00 AM,Agree,Agree
06/22/2022,NC,2847981,2374449,473532,3966,960,25570,22272,3298,18,5,06/22/2022 12:00:00 AM,Agree,Agree
07/03/2020,NC,70466,70389,77,2049,10,1493,1493,0,12,0,07/03/2020 12:00:00 AM,Agree,Agree
05/31/2020,NC,28686,28685,1,905,0,988,988,0,19,0,05/31/2020 12:00:00 AM,Agree,Agree
08/29/2022,NC,3121964,2586966,534998,1861,290,26515,23048,3467,10,1,08/29/2022 12:00:00 AM,Agree,Agree
06/02/2021,NC,989267,851711,137556,421,100,13493,11899,1594,9,2,06/02/2021 12:00:00 AM,Agree,Agree
08/30/2020,NC,169185,166444,2741,1661,24,2957,2946,11,39,0,08/30/2020 12:00:00 AM,Agree,Agree
05/24/2022,NC,2742820,2290943,451877,3411,936,25260,22023,3237,9,2,05/24/2022 12:00:00 AM,Agree,Agree
03/31/2020,NC,1428,1428,0,194,0,13,13,0,2,0,03/31/2020 12:00:00 AM,Agree,Agree
11/10/2020,NC,296621,282694,13927,2589,454,5086,4949,137,34,5,11/10/2020 12:00:00 AM,Agree,Agree
02/24/2020,NC,0,,,0,,0,,,0,,03/26/2020 04:22:39 PM,Agree,Agree
08/13/2021,NC,1100664,939826,160838,6151,1143,14142,12460,1682,37,5,08/13/2021 12:00:00 AM,Agree,Agree
09/10/2021,NC,1281581,1091278,190303,8326,1482,15795,13887,1908,66,12,09/10/2021 12:00:00 AM,Agree,Agree
09/11/2020,NC,185149,181579,3570,1703,87,3294,3272,22,35,2,09/11/2020 12:00:00 AM,Agree,Agree
03/09/2021,NC,867200,759579,107621,1428,531,12491,11042,1449,17,4,03/09/2021 12:00:00 AM,Agree,Agree
01/27/2022,NC,2398270,2015481,382789,25489,4328,21811,19123,2688,96,19,01/27/2022 12:00:00 AM,Agree,Agree
01/22/2022,NC,2300179,1935504,364675,35906,4392,21293,18694,2599,80,11,01/22/2022 12:00:00 AM,Agree,Agree
11/20/2021,NC,1505790,1275457,230333,2114,426,18880,16616,2264,17,4,11/20/2021 12:00:00 AM,Agree,Agree
12/25/2021,NC,1619446,1366301,253145,6896,1006,19655,17307,2348,30,5,12/25/2021 12:00:00 AM,Agree,Agree
05/22/2020,NC,21775,21774,1,789,0,784,784,0,18,0,05/22/2020 12:00:00 AM,Agree,Agree
09/11/2021,NC,1289658,1098037,191621,8077,1318,15877,13959,1918,82,10,09/11/2021 12:00:00 AM,Agree,Agree
01/07/2022,NC,1841019,1548310,292709,31805,5505,20157,17725,2432,60,10,01/07/2022 12:00:00 AM,Agree,Agree
02/17/2022,NC,2584312,2165442,418870,4834,1134,23726,20697,3029,69,13,02/17/2022 12:00:00 AM,Agree,Agree
01/25/2020,NC,0,,,0,,0,,,0,,03/26/2020 04:22:39 PM,Agree,Agree
11/22/2020,NC,337681,319149,18532,2749,230,5537,5356,181,39,8,11/22/2020 12:00:00 AM,Agree,Agree
11/10/2021,NC,1486385,1259997,226388,2073,521,18709,16471,2238,16,2,11/10/2021 12:00:00 AM,Agree,Agree
11/15/2021,NC,1494942,1267094,227848,1206,126,18783,16535,2248,9,2,11/15/2021 12:00:00 AM,Agree,Agree
03/20/2022,NC,2625583,2197102,428481,377,52,24801,21624,3177,18,0,03/20/2022 12:00:00 AM,Agree,Agree
11/23/2020,NC,340091,321356,18735,2410,203,5586,5400,186,49,5,11/23/2020 12:00:00 AM,Agree,Agree
06/04/2021,NC,990554,852649,137905,603,148,13510,11915,1595,5,1,06/04/2021 12:00:00 AM,Agree,Agree
05/12/2020,NC,15590,15590,0,326,0,640,640,0,15,0,05/12/2020 12:00:00 AM,Agree,Agree
11/24/2020,NC,344073,324650,19423,3982,688,5622,5432,190,36,4,11/24/2020 12:00:00 AM,Agree,Agree
11/25/2021,NC,1515007,1282779,232228,2245,489,18971,16700,2271,14,2,11/25/2021 12:00:00 AM,Agree,Agree
02/09/2022,NC,2544705,2134858,409847,7900,2004,23104,20183,2921,100,14,02/09/2022 12:00:00 AM,Agree,Agree
01/29/2021,NC,748741,669663,79078,5138,787,10803,9630,1173,85,14,01/29/2021 12:00:00 AM,Agree,Agree
01/25/2021,NC,727128,652195,74933,3750,402,10428,9333,1095,76,14,01/25/2021 12:00:00 AM,Agree,Agree
01/09/2022,NC,1895807,1595308,300499,22302,2680,20291,17836,2455,66,13,01/09/2022 12:00:00 AM,Agree,Agree
05/12/2022,NC,2697298,2254217,443081,4026,759,25185,21959,3226,11,3,05/12/2022 12:00:00 AM,Agree,Agree
03/08/2021,NC,865772,758682,107090,975,233,12474,11029,1445,13,1,03/08/2021 12:00:00 AM,Agree,Agree
12/25/2020,NC,513127,470601,42526,5446,437,7421,6914,507,77,14,12/25/2020 12:00:00 AM,Agree,Agree
05/05/2021,NC,964235,832661,131574,1700,442,13180,11636,1544,17,3,05/05/2021 12:00:00 AM,Agree,Agree
01/01/2021,NC,558303,508513,49790,11001,1433,8007,7403,604,81,11,01/01/2021 12:00:00 AM,Agree,Agree
05/07/2021,NC,967484,835152,132332,1524,360,13202,11656,1546,8,0,05/07/2021 12:00:00 AM,Agree,Agree
06/26/2021,NC,999274,858923,140351,433,119,13635,12021,1614,9,1,06/26/2021 12:00:00 AM,Agree,Agree
06/19/2020,NC,50017,50008,9,1604,1,1287,1287,0,16,0,06/19/2020 12:00:00 AM,Agree,Agree
01/11/2022,NC,1939963,1631609,308354,26375,6047,20421,17956,2465,71,6,01/11/2022 12:00:00 AM,Agree,Agree
10/11/2021,NC,1428029,1213891,214138,1574,143,17764,15618,2146,40,6,10/11/2021 12:00:00 AM,Agree,Agree
02/10/2020,NC,0,,,0,,0,,,0,,03/26/2020 04:22:39 PM,Agree,Agree
06/08/2022,NC,2800954,2337046,463908,4262,1018,25413,22149,3264,11,3,06/08/2022 12:00:00 AM,Agree,Agree
02/18/2020,NC,0,,,0,,0,,,0,,03/26/2020 04:22:39 PM,Agree,Agree
03/26/2022,NC,2629089,2199651,429438,592,204,24878,21697,3181,12,0,03/26/2022 12:00:00 AM,Agree,Agree
04/09/2020,NC,3698,3698,0,248,0,81,81,0,9,0,04/09/2020 12:00:00 AM,Agree,Agree
06/16/2021,NC,995337,856165,139172,504,155,13584,11977,1607,3,2,06/16/2021 12:00:00 AM,Agree,Agree
08/14/2022,NC,3074373,2550059,524314,2676,438,26293,22861,3432,15,3,08/14/2022 12:00:00 AM,Agree,Agree
04/06/2021,NC,912526,793367,119159,1139,232,12843,11349,1494,10,1,04/06/2021 12:00:00 AM,Agree,Agree
05/31/2022,NC,2769871,2312693,457178,2261,450,25330,22080,3250,9,1,05/31/2022 12:00:00 AM,Agree,Agree
08/26/2021,NC,1178176,1004460,173716,8197,1361,14751,12976,1775,48,8,08/26/2021 12:00:00 AM,Agree,Agree
09/30/2020,NC,210333,204933,5400,1400,159,3834,3789,45,32,2,09/30/2020 12:00:00 AM,Agree,Agree
03/31/2021,NC,903500,786442,117058,1880,548,12779,11293,1486,18,3,03/31/2021 12:00:00 AM,Agree,Agree
10/05/2021,NC,1408759,1197904,210855,2843,768,17486,15377,2109,65,11,10/05/2021 12:00:00 AM,Agree,Agree
04/27/2020,NC,9335,9335,0,411,0,384,384,0,24,0,10/05/2022 12:29:35 PM,Agree,Agree
09/01/2021,NC,1219370,1039274,180096,7498,1628,15156,13332,1824,81,11,09/01/2021 12:00:00 AM,Agree,Agree
08/05/2021,NC,1061469,907883,153586,4937,898,13941,12288,1653,17,3,08/05/2021 12:00:00 AM,Agree,Agree
05/25/2020,NC,23843,23842,1,556,0,845,845,0,19,0,05/25/2020 12:00:00 AM,Agree,Agree
09/22/2021,NC,1354313,1152417,201896,5289,1072,16657,14651,2006,57,8,09/22/2021 12:00:00 AM,Agree,Agree
04/30/2020,NC,10705,10705,0,566,0,433,433,0,19,0,04/30/2020 12:00:00 AM,Agree,Agree
08/10/2021,NC,1082388,925059,157329,4381,1089,14042,12378,1664,19,0,08/10/2021 12:00:00 AM,Agree,Agree
07/10/2020,NC,81667,81501,166,1991,20,1603,1602,1,12,0,07/10/2020 12:00:00 AM,Agree,Agree
01/24/2022,NC,2332152,1964150,368002,11601,1357,21482,18855,2627,109,19,01/24/2022 12:00:00 AM,Agree,Agree
12/16/2020,NC,456714,422172,34542,6111,1132,6769,6400,369,68,10,12/16/2020 12:00:00 AM,Agree,Agree
11/11/2021,NC,1488433,1261634,226799,2048,411,18723,16484,2239,14,1,11/11/2021 12:00:00 AM,Agree,Agree
10/21/2020,NC,250375,241094,9281,2071,319,4396,4315,81,33,3,10/21/2020 12:00:00 AM,Agree,Agree
08/07/2022,NC,3046177,2528027,518150,3516,445,26187,22775,3412,17,0,08/07/2022 12:00:00 AM,Agree,Agree
06/27/2022,NC,2865694,2388578,477116,2252,407,25635,22327,3308,12,5,06/27/2022 12:00:00 AM,Agree,Agree
04/10/2020,NC,3993,3993,0,295,0,91,91,0,10,0,04/10/2020 12:00:00 AM,Agree,Agree
11/16/2021,NC,1496646,1268332,228314,1704,466,18801,16550,2251,18,3,11/16/2021 12:00:00 AM,Agree,Agree
03/07/2020,NC,2,2,0,1,0,0,0,0,0,0,03/07/2020 12:00:00 AM,Agree,Agree
02/22/2021,NC,838265,737635,100630,1552,313,12148,10754,1394,38,6,02/22/2021 12:00:00 AM,Agree,Agree
05/20/2020,NC,20174,20174,0,509,0,751,751,0,19,0,05/20/2020 12:00:00 AM,Agree,Agree
05/08/2020,NC,14047,14047,0,504,0,570,570,0,19,0,05/08/2020 12:00:00 AM,Agree,Agree
12/01/2021,NC,1526619,1291783,234836,3395,847,19080,16800,2280,15,1,12/01/2021 12:00:00 AM,Agree,Agree
04/13/2021,NC,925554,803184,122370,1899,544,12920,11418,1502,11,0,04/13/2021 12:00:00 AM,Agree,Agree
02/23/2021,NC,840720,739307,101413,2455,783,12176,10774,1402,28,8,02/23/2021 12:00:00 AM,Agree,Agree
10/01/2022,NC,3208983,2652176,556807,1600,352,26850,23329,3521,1,0,10/01/2022 12:00:00 AM,Agree,Agree
12/21/2020,NC,488451,449988,38463,4736,370,7124,6679,445,65,8,12/21/2020 12:00:00 AM,Agree,Agree
08/02/2022,NC,3021532,2508650,512882,4370,1185,26117,22711,3406,12,1,08/02/2022 12:00:00 AM,Agree,Agree
05/02/2021,NC,960362,829796,130566,1333,267,13135,11600,1535,6,2,05/02/2021 12:00:00 AM,Agree,Agree
08/24/2020,NC,158948,156711,2237,1214,15,2790,2781,9,28,1,08/24/2020 12:00:00 AM,Agree,Agree
01/18/2021,NC,685700,618017,67683,4163,408,9724,8774,950,85,19,01/18/2021 12:00:00 AM,Agree,Agree
11/24/2021,NC,1512762,1281023,231739,2294,536,18957,16688,2269,20,4,11/24/2021 12:00:00 AM,Agree,Agree
07/01/2021,NC,1001213,860328,140885,518,118,13650,12035,1615,5,1,07/01/2021 12:00:00 AM,Agree,Agree
07/11/2020,NC,83902,83712,190,2235,24,1627,1626,1,24,0,07/11/2020 12:00:00 AM,Agree,Agree
10/15/2020,NC,238474,230462,8012,2572,264,4213,4143,70,23,3,10/15/2020 12:00:00 AM,Agree,Agree
05/27/2020,NC,24924,24923,1,618,0,905,905,0,28,0,05/27/2020 12:00:00 AM,Agree,Agree
01/21/2021,NC,704635,632857,71778,7095,1027,10072,9051,1021,113,22,01/21/2021 12:00:00 AM,Agree,Agree
07/14/2020,NC,89772,89550,222,2075,23,1684,1683,1,13,0,07/14/2020 12:00:00 AM,Agree,Agree
06/08/2020,NC,36741,36736,5,1110,0,1127,1127,0,13,0,06/08/2020 12:00:00 AM,Agree,Agree
03/14/2020,NC,22,22,0,5,0,1,1,0,0,0,03/14/2020 12:00:00 AM,Agree,Agree
11/01/2020,NC,275693,263971,11722,1980,64,4768,4657,111,34,3,11/01/2020 12:00:00 AM,Agree,Agree
07/16/2021,NC,1011679,868001,143678,1218,308,13717,12094,1623,6,1,07/16/2021 12:00:00 AM,Agree,Agree
02/08/2021,NC,797181,705661,91520,2694,383,11514,10222,1292,67,10,02/08/2021 12:00:00 AM,Agree,Agree
03/08/2022,NC,2618039,2191268,426771,727,249,24543,21404,3139,36,3,03/08/2022 12:00:00 AM,Agree,Agree
06/06/2020,NC,34696,34691,5,1321,1,1097,1097,0,21,0,06/06/2020 12:00:00 AM,Agree,Agree
07/28/2021,NC,1033197,884863,148334,3206,737,13818,12181,1637,10,2,07/28/2021 12:00:00 AM,Agree,Agree
08/21/2021,NC,1146106,977618,168488,6568,1038,14481,12742,1739,59,6,08/21/2021 12:00:00 AM,Agree,Agree
08/25/2020,NC,160428,158072,2356,1480,119,2813,2803,10,23,1,08/25/2020 12:00:00 AM,Agree,Agree
08/11/2022,NC,3062788,2540864,521924,5051,1025,26247,22826,3421,16,2,08/11/2022 12:00:00 AM,Agree,Agree
11/29/2020,NC,362955,341500,21455,3316,302,5827,5610,217,48,4,11/29/2020 12:00:00 AM,Agree,Agree
06/28/2020,NC,62414,62378,36,1528,1,1419,1419,0,12,0,06/28/2020 12:00:00 AM,Agree,Agree
04/01/2020,NC,1579,1579,0,151,0,16,16,0,3,0,04/01/2020 12:00:00 AM,Agree,Agree
08/05/2022,NC,3037731,2521086,516645,5275,1108,26159,22749,3410,15,1,08/05/2022 12:00:00 AM,Agree,Agree
04/12/2022,NC,2638999,2207497,431502,824,182,25004,21809,3195,6,3,04/12/2022 12:00:00 AM,Agree,Agree
03/19/2022,NC,2625206,2196777,428429,501,124,24783,21606,3177,15,3,03/19/2022 12:00:00 AM,Agree,Agree
08/01/2020,NC,124716,123749,967,1965,68,2131,2128,3,30,0,08/01/2020 12:00:00 AM,Agree,Agree
06/10/2020,NC,38429,38423,6,860,0,1161,1161,0,13,0,06/10/2020 12:00:00 AM,Agree,Agree
05/03/2022,NC,2671148,2233296,437852,1657,472,25125,21909,3216,8,2,05/03/2022 12:00:00 AM,Agree,Agree
05/28/2022,NC,2761703,2305846,455857,4185,850,25302,22056,3246,8,3,05/28/2022 12:00:00 AM,Agree,Agree
10/16/2021,NC,1442465,1225195,217270,2578,547,17979,15809,2170,37,5,10/16/2021 12:00:00 AM,Agree,Agree
03/13/2021,NC,874445,764795,109650,1803,586,12554,11098,1456,14,0,03/13/2021 12:00:00 AM,Agree,Agree
10/06/2020,NC,220702,214434,6268,1388,229,3973,3922,51,27,3,10/06/2020 12:00:00 AM,Agree,Agree
08/23/2021,NC,1156137,986833,169304,4544,359,14584,12826,1758,58,10,08/23/2021 12:00:00 AM,Agree,Agree
01/07/2021,NC,603362,546532,56830,10648,1384,8614,7878,736,104,24,01/07/2021 12:00:00 AM,Agree,Agree
02/17/2020,NC,0,,,0,,0,,,0,,03/26/2020 04:22:39 PM,Agree,Agree
03/13/2022,NC,2621912,2194247,427665,389,65,24674,21514,3160,17,1,03/13/2022 12:00:00 AM,Agree,Agree
12/15/2021,NC,1570623,1326455,244168,3822,963,19384,17062,2322,34,2,12/15/2021 12:00:00 AM,Agree,Agree
11/28/2020,NC,359639,338486,21153,3504,278,5779,5566,213,44,7,11/28/2020 12:00:00 AM,Agree,Agree
03/24/2022,NC,2627600,2198599,429001,630,155,24858,21677,3181,11,0,03/24/2022 12:00:00 AM,Agree,Agree
01/26/2021,NC,731826,655702,76124,4698,1191,10528,9411,1117,100,22,01/26/2021 12:00:00 AM,Agree,Agree
08/04/2021,NC,1056532,903844,152688,4188,845,13924,12274,1650,19,2,08/04/2021 12:00:00 AM,Agree,Agree
02/24/2021,NC,843392,741318,102074,2672,661,12215,10803,1412,39,10,02/24/2021 12:00:00 AM,Agree,Agree
04/07/2020,NC,3150,3150,0,262,0,63,63,0,4,0,04/07/2020 12:00:00 AM,Agree,Agree
03/17/2022,NC,2624038,2195860,428178,643,132,24745,21574,3171,21,2,03/17/2022 12:00:00 AM,Agree,Agree
11/04/2021,NC,1476935,1252544,224391,2003,516,18589,16362,2227,20,1,11/04/2021 12:00:00 AM,Agree,Agree
01/31/2021,NC,758881,678465,80416,4329,429,10970,9774,1196,77,11,01/31/2021 12:00:00 AM,Agree,Agree
05/31/2021,NC,988557,851187,137370,310,64,13473,11882,1591,7,0,05/31/2021 12:00:00 AM,Agree,Agree
12/03/2020,NC,380963,356468,24495,6075,815,5980,5740,240,43,7,12/03/2020 12:00:00 AM,Agree,Agree
04/18/2021,NC,936140,811419,124721,1560,333,12972,11461,1511,14,3,04/18/2021 12:00:00 AM,Agree,Agree
11/06/2021,NC,1480455,1255344,225111,1697,329,18636,16402,2234,21,4,11/06/2021 12:00:00 AM,Agree,Agree
01/17/2021,NC,681537,614262,67275,6330,421,9639,8708,931,101,22,01/17/2021 12:00:00 AM,Agree,Agree
06/03/2022,NC,2783570,2323247,460323,5253,935,25372,22114,3258,14,2,06/03/2022 12:00:00 AM,Agree,Agree
09/14/2022,NC,3170261,2622926,547335,3592,978,26716,23215,3501,13,3,09/14/2022 12:00:00 AM,Agree,Agree
05/21/2022,NC,2733401,2283312,450089,4702,917,25240,22006,3234,2,0,05/21/2022 12:00:00 AM,Agree,Agree
09/06/2022,NC,3145013,2604345,540668,1792,408,26611,23124,3487,8,2,09/06/2022 12:00:00 AM,Agree,Agree
03/30/2020,NC,1234,1234,0,129,0,11,11,0,4,0,03/30/2020 12:00:00 AM,Agree,Agree
03/04/2020,NC,1,1,0,0,0,0,0,0,0,0,03/04/2020 12:00:00 AM,Agree,Agree
07/29/2021,NC,1036768,887746,149022,3571,688,13835,12196,1639,17,2,07/29/2021 12:00:00 AM,Agree,Agree
02/26/2021,NC,848821,745630,103191,2550,506,12275,10853,1422,32,3,02/26/2021 12:00:00 AM,Agree,Agree
05/28/2020,NC,25582,25581,1,658,0,930,930,0,25,0,05/28/2020 12:00:00 AM,Agree,Agree
08/19/2021,NC,1132845,966533,166312,6992,1234,14385,12661,1724,37,4,08/19/2021 12:00:00 AM,Agree,Agree
03/25/2021,NC,893615,779111,114504,1974,423,12709,11235,1474,10,2,03/25/2021 12:00:00 AM,Agree,Agree
06/17/2022,NC,2832769,2362374,470395,3803,787,25517,22232,3285,8,2,06/17/2022 12:00:00 AM,Agree,Agree
11/19/2021,NC,1503676,1273769,229907,2437,523,18863,16603,2260,23,3,11/19/2021 12:00:00 AM,Agree,Agree
02/18/2021,NC,828941,730519,98422,3283,732,12012,10640,1372,42,7,02/18/2021 12:00:00 AM,Agree,Agree
09/28/2020,NC,207582,202545,5037,799,36,3770,3728,42,30,0,09/28/2020 12:00:00 AM,Agree,Agree
02/11/2022,NC,2558894,2145878,413016,6568,1503,23272,20318,2954,89,21,02/11/2022 12:00:00 AM,Agree,Agree
06/20/2021,NC,996968,857362,139606,323,73,13599,11990,1609,3,1,06/20/2021 12:00:00 AM,Agree,Agree
09/14/2021,NC,1306872,1112918,193954,6275,1389,16110,14170,1940,84,11,09/14/2021 12:00:00 AM,Agree,Agree
05/20/2022,NC,2728699,2279527,449172,4834,962,25238,22004,3234,5,0,05/20/2022 12:00:00 AM,Agree,Agree
02/09/2021,NC,800428,707892,92536,3247,1016,11571,10268,1303,57,11,02/09/2021 12:00:00 AM,Agree,Agree
11/19/2020,NC,326926,309535,17391,4368,475,5415,5253,162,35,1,11/19/2020 12:00:00 AM,Agree,Agree
07/23/2020,NC,107209,106711,498,2411,54,1890,1888,2,27,0,07/23/2020 12:00:00 AM,Agree,Agree
12/13/2021,NC,1563879,1321449,242430,1967,251,19322,17005,2317,17,2,12/13/2021 12:00:00 AM,Agree,Agree
01/01/2022,NC,1713756,1444405,269351,21161,3156,19853,17471,2382,22,1,01/01/2022 12:00:00 AM,Agree,Agree
08/16/2020,NC,146891,145145,1746,1328,33,2561,2555,6,27,1,08/16/2020 12:00:00 AM,Agree,Agree
12/12/2021,NC,1561912,1319733,242179,2689,372,19305,16990,2315,18,5,12/12/2021 12:00:00 AM,Agree,Agree
10/05/2022,NC,3212286,2654738,557548,0,0,26853,23332,3521,0,0,10/06/2022 01:30:56 PM,Agree,Agree
03/02/2021,NC,855324,750670,104654,1634,552,12365,10936,1429,21,0,03/02/2021 12:00:00 AM,Agree,Agree
11/07/2020,NC,290239,276971,13268,2505,296,4982,4855,127,35,3,11/07/2020 12:00:00 AM,Agree,Agree
12/27/2021,NC,1628566,1374622,253944,4255,362,19710,17351,2359,27,5,12/27/2021 12:00:00 AM,Agree,Agree
06/25/2022,NC,2860471,2384195,476276,4028,881,25614,22312,3302,12,2,06/25/2022 12:00:00 AM,Agree,Agree
07/23/2022,NC,2974976,2472725,502251,5239,1215,25974,22595,3379,19,6,07/23/2022 12:00:00 AM,Agree,Agree
06/11/2021,NC,993515,854817,138698,478,134,13558,11954,1604,9,3,06/11/2021 12:00:00 AM,Agree,Agree
09/26/2020,NC,205527,200558,4969,1628,121,3714,3674,40,27,1,09/26/2020 12:00:00 AM,Agree,Agree
08/30/2022,NC,3124862,2589048,535814,2898,816,26527,23058,3469,12,2,08/30/2022 12:00:00 AM,Agree,Agree
03/25/2020,NC,544,544,0,121,0,3,3,0,1,0,03/25/2020 12:00:00 AM,Agree,Agree
07/18/2021,NC,1013850,869632,144218,943,218,13728,12101,1627,4,2,07/18/2021 12:00:00 AM,Agree,Agree
02/04/2021,NC,782254,693165,89089,5523,996,11268,10013,1255,56,14,02/04/2021 12:00:00 AM,Agree,Agree
03/04/2022,NC,2615100,2189045,426055,1326,345,24417,21292,3125,34,4,03/04/2022 12:00:00 AM,Agree,Agree
12/02/2020,NC,374888,351208,23680,5224,877,5937,5704,233,38,4,12/02/2020 12:00:00 AM,Agree,Agree
09/18/2021,NC,1334813,1135994,198819,5960,1107,16413,14430,1983,69,5,09/18/2021 12:00:00 AM,Agree,Agree
12/20/2021,NC,1589136,1341469,247667,2761,405,19506,17173,2333,27,1,12/20/2021 12:00:00 AM,Agree,Agree
07/02/2021,NC,1001715,860684,141031,502,146,13657,12042,1615,7,0,07/02/2021 12:00:00 AM,Agree,Agree
06/07/2020,NC,35631,35626,5,935,0,1114,1114,0,17,0,06/07/2020 12:00:00 AM,Agree,Agree
05/27/2021,NC,986368,849521,136847,880,183,13444,11856,1588,8,0,05/27/2021 12:00:00 AM,Agree,Agree
10/18/2021,NC,1445779,1228121,217658,1363,170,18068,15888,2180,46,4,10/18/2021 12:00:00 AM,Agree,Agree
08/07/2020,NC,134035,132760,1275,1848,65,2303,2299,4,24,0,08/07/2020 12:00:00 AM,Agree,Agree
04/25/2022,NC,2656153,2221402,434751,1037,156,25074,21867,3207,5,0,04/25/2022 12:00:00 AM,Agree,Agree
05/19/2022,NC,2723865,2275655,448210,5233,1023,25233,21999,3234,5,1,05/19/2022 12:00:00 AM,Agree,Agree
03/29/2021,NC,900067,784019,116048,1012,279,12752,11270,1482,10,5,03/29/2021 12:00:00 AM,Agree,Agree
04/12/2020,NC,4534,4534,0,305,0,107,107,0,9,0,04/12/2020 12:00:00 AM,Agree,Agree
08/22/2022,NC,3099730,2569893,529837,1911,277,26419,22964,3455,15,1,08/22/2022 12:00:00 AM,Agree,Agree
04/10/2021,NC,920830,799623,121207,2093,480,12883,11384,1499,13,2,04/10/2021 12:00:00 AM,Agree,Agree
06/14/2022,NC,2821290,2353478,467812,2909,752,25489,22207,3282,12,3,06/14/2022 12:00:00 AM,Agree,Agree
10/17/2021,NC,1444416,1226928,217488,1951,218,18022,15846,2176,43,6,10/17/2021 12:00:00 AM,Agree,Agree
09/16/2021,NC,1321644,1125000,196644,7872,1216,16264,14300,1964,73,13,09/16/2021 12:00:00 AM,Agree,Agree
04/17/2022,NC,2645289,2212547,432742,906,151,25043,21844,3199,6,0,04/17/2022 12:00:00 AM,Agree,Agree
03/23/2020,NC,325,325,0,38,0,2,2,0,1,0,03/23/2020 12:00:00 AM,Agree,Agree
05/09/2021,NC,970003,837227,132776,1141,187,13230,11676,1554,14,3,05/09/2021 12:00:00 AM,Agree,Agree
10/04/2022,NC,3212286,2654738,557548,1382,385,26853,23332,3521,0,0,10/05/2022 01:16:55 PM,Agree,Agree
08/29/2020,NC,167524,164807,2717,1546,74,2918,2907,11,28,1,08/29/2020 12:00:00 AM,Agree,Agree
03/19/2020,NC,104,104,0,42,0,1,1,0,0,0,03/19/2020 12:00:00 AM,Agree,Agree
12/23/2021,NC,1605251,1354304,250947,6971,1237,19597,17258,2339,36,2,12/23/2021 12:00:00 AM,Agree,Agree
03/12/2020,NC,9,9,0,2,0,0,0,0,0,0,03/12/2020 12:00:00 AM,Agree,Agree
08/10/2022,NC,3057737,2536838,520899,5061,1272,26231,22812,3419,16,1,08/10/2022 12:00:00 AM,Agree,Agree
01/23/2022,NC,2320551,1953906,366645,20372,1970,21373,18765,2608,80,9,01/23/2022 12:00:00 AM,Agree,Agree
09/03/2021,NC,1236800,1053739,183061,8648,1450,15299,13457,1842,74,12,09/03/2021 12:00:00 AM,Agree,Agree
12/12/2020,NC,435611,404318,31293,7079,958,6483,6159,324,69,12,12/12/2020 12:00:00 AM,Agree,Agree
05/17/2020,NC,18739,18739,0,481,0,705,705,0,11,0,05/17/2020 12:00:00 AM,Agree,Agree
06/13/2022,NC,2818381,2351321,467060,2156,273,25477,22198,3279,14,1,06/13/2022 12:00:00 AM,Agree,Agree
02/16/2022,NC,2579478,2161742,417736,4588,1266,23657,20641,3016,68,11,02/16/2022 12:00:00 AM,Agree,Agree
01/21/2022,NC,2264273,1903990,360283,38336,6103,21213,18625,2588,95,19,01/21/2022 12:00:00 AM,Agree,Agree
04/26/2021,NC,949906,821857,128049,1020,212,13069,11544,1525,10,2,04/26/2021 12:00:00 AM,Agree,Agree
10/31/2021,NC,1470650,1247761,222889,1282,182,18495,16275,2220,28,0,10/31/2021 12:00:00 AM,Agree,Agree
08/28/2020,NC,165978,163335,2643,1983,82,2890,2880,10,25,0,08/28/2020 12:00:00 AM,Agree,Agree
10/06/2021,NC,1412363,1200629,211734,3604,879,17537,15422,2115,51,6,10/06/2021 12:00:00 AM,Agree,Agree
06/23/2021,NC,997987,858031,139956,485,193,13614,12002,1612,4,0,06/23/2021 12:00:00 AM,Agree,Agree
11/06/2020,NC,287734,274762,12972,2928,272,4947,4823,124,33,1,11/06/2020 12:00:00 AM,Agree,Agree
07/20/2020,NC,101090,100718,372,1319,4,1807,1805,2,20,0,07/20/2020 12:00:00 AM,Agree,Agree
12/10/2021,NC,1555864,1314775,241089,3679,766,19271,16964,2307,29,3,12/10/2021 12:00:00 AM,Agree,Agree
07/08/2022,NC,2907120,2420160,486960,5334,1204,25773,22437,3336,12,2,07/08/2022 12:00:00 AM,Agree,Agree
01/13/2021,NC,650973,587582,63391,7630,1404,9213,8363,850,106,24,01/13/2021 12:00:00 AM,Agree,Agree
02/07/2020,NC,0,,,0,,0,,,0,,03/26/2020 04:22:39 PM,Agree,Agree
09/19/2021,NC,1339742,1140417,199325,4929,506,16473,14487,1986,60,3,09/19/2021 12:00:00 AM,Agree,Agree
02/04/2022,NC,2507602,2105193,402409,11325,2375,22595,19759,2836,119,22,02/04/2022 12:00:00 AM,Agree,Agree
04/09/2022,NC,2636961,2205807,431154,842,157,24988,21796,3192,6,0,04/09/2022 12:00:00 AM,Agree,Agree
02/08/2022,NC,2536805,2128962,407843,8081,1910,23004,20097,2907,95,16,02/08/2022 12:00:00 AM,Agree,Agree
12/11/2021,NC,1559223,1317416,241807,3359,718,19287,16977,2310,16,3,12/11/2021 12:00:00 AM,Agree,Agree
09/21/2021,NC,1349024,1148200,200824,5580,1211,16600,14602,1998,60,4,09/21/2021 12:00:00 AM,Agree,Agree
08/20/2021,NC,1139538,972088,167450,6693,1138,14422,12689,1733,37,9,08/20/2021 12:00:00 AM,Agree,Agree
11/05/2020,NC,284806,272106,12700,2811,252,4914,4791,123,33,3,11/05/2020 12:00:00 AM,Agree,Agree
05/07/2020,NC,13543,13543,0,631,0,551,551,0,12,0,05/07/2020 12:00:00 AM,Agree,Agree
04/06/2022,NC,2634456,2203808,430648,691,187,24963,21772,3191,8,0,04/06/2022 12:00:00 AM,Agree,Agree
07/20/2021,NC,1016005,871299,144706,1376,359,13738,12111,1627,8,0,07/20/2021 12:00:00 AM,Agree,Agree
08/27/2020,NC,163995,161434,2561,2162,99,2865,2855,10,22,0,08/27/2020 12:00:00 AM,Agree,Agree
08/31/2020,NC,170283,167526,2757,1098,16,2982,2970,12,25,1,08/31/2020 12:00:00 AM,Agree,Agree
12/11/2020,NC,428532,398197,30335,6623,895,6414,6102,312,65,14,12/11/2020 12:00:00 AM,Agree,Agree
08/24/2022,NC,3106674,2574948,531726,3866,1037,26446,22989,3457,16,1,08/24/2022 12:00:00 AM,Agree,Agree
10/22/2020,NC,252873,243384,9489,2498,208,4431,4347,84,35,3,10/22/2020 12:00:00 AM,Agree,Agree
08/01/2021,NC,1046906,896054,150852,2967,412,13877,12233,1644,18,3,08/01/2021 12:00:00 AM,Agree,Agree
07/17/2020,NC,95656,95327,329,1964,39,1747,1745,2,22,0,07/17/2020 12:00:00 AM,Agree,Agree
07/26/2021,NC,1027465,880486,146979,1575,161,13793,12159,1634,9,2,07/26/2021 12:00:00 AM,Agree,Agree
06/15/2022,NC,2825065,2356307,468758,3775,946,25505,22222,3283,16,1,06/15/2022 12:00:00 AM,Agree,Agree
06/28/2022,NC,2868875,2390820,478055,3181,939,25644,22333,3311,9,3,06/28/2022 12:00:00 AM,Agree,Agree
01/08/2021,NC,614302,555995,58307,10940,1477,8715,7963,752,101,16,01/08/2021 12:00:00 AM,Agree,Agree
11/22/2021,NC,1508723,1277988,230735,1296,166,18919,16654,2265,20,0,11/22/2021 12:00:00 AM,Agree,Agree
07/14/2021,NC,1009359,866277,143082,1065,334,13707,12086,1621,6,1,07/14/2021 12:00:00 AM,Agree,Agree
08/03/2021,NC,1052344,900501,151843,3271,719,13905,12257,1648,15,2,08/03/2021 12:00:00 AM,Agree,Agree
07/21/2020,NC,102985,102591,394,1895,22,1838,1836,2,31,0,07/21/2020 12:00:00 AM,Agree,Agree
03/27/2020,NC,791,791,0,130,0,5,5,0,1,0,03/27/2020 12:00:00 AM,Agree,Agree
10/31/2020,NC,273713,262055,11658,2313,228,4734,4626,108,34,2,10/31/2020 12:00:00 AM,Agree,Agree
09/23/2022,NC,3193918,2640642,553276,2493,651,26806,23293,3513,8,2,09/23/2022 12:00:00 AM,Agree,Agree
09/10/2022,NC,3159639,2614901,544738,3599,865,26661,23172,3489,18,0,09/10/2022 12:00:00 AM,Agree,Agree
04/03/2021,NC,909195,790788,118407,1724,351,12810,11322,1488,11,0,04/03/2021 12:00:00 AM,Agree,Agree
04/16/2022,NC,2644383,2211792,432591,1255,183,25037,21838,3199,11,1,04/16/2022 12:00:00 AM,Agree,Agree
10/27/2021,NC,1463352,1241797,221555,2262,556,18386,16176,2210,33,4,10/27/2021 12:00:00 AM,Agree,Agree
09/04/2021,NC,1244783,1060497,184286,7983,1225,15384,13533,1851,85,9,09/04/2021 12:00:00 AM,Agree,Agree
02/20/2022,NC,2593938,2172971,420967,2356,414,23921,20865,3056,69,10,02/20/2022 12:00:00 AM,Agree,Agree
02/25/2022,NC,2605747,2181936,423811,2898,627,24162,21072,3090,39,5,02/25/2022 12:00:00 AM,Agree,Agree
08/27/2021,NC,1186123,1011140,174983,7947,1267,14818,13038,1780,67,5,08/27/2021 12:00:00 AM,Agree,Agree
09/29/2022,NC,3205517,2649482,556035,2448,494,26846,23325,3521,5,0,09/29/2022 12:00:00 AM,Agree,Agree
06/08/2021,NC,992094,853789,138305,382,106,13538,11938,1600,5,2,06/08/2021 12:00:00 AM,Agree,Agree
09/14/2020,NC,188553,184854,3699,813,26,3367,3341,26,24,2,09/14/2020 12:00:00 AM,Agree,Agree
07/22/2022,NC,2969737,2468701,501036,5642,1295,25955,22582,3373,15,2,07/22/2022 12:00:00 AM,Agree,Agree
06/17/2021,NC,995760,856477,139283,423,111,13589,11981,1608,5,1,06/17/2021 12:00:00 AM,Agree,Agree
11/30/2021,NC,1523224,1289235,233989,2429,709,19065,16786,2279,12,1,11/30/2021 12:00:00 AM,Agree,Agree
07/31/2020,NC,122751,121852,899,1926,69,2101,2098,3,32,0,07/31/2020 12:00:00 AM,Agree,Agree
06/02/2022,NC,2778317,2318929,459388,5423,1175,25358,22102,3256,13,2,06/02/2022 12:00:00 AM,Agree,Agree
03/09/2020,NC,2,2,0,0,0,0,0,0,0,0,03/09/2020 12:00:00 AM,Agree,Agree
08/28/2021,NC,1194179,1018124,176055,8056,1072,14886,13098,1788,68,8,08/28/2021 12:00:00 AM,Agree,Agree
10/25/2020,NC,259712,249587,10125,1782,83,4518,4426,92,37,6,10/25/2020 12:00:00 AM,Agree,Agree
01/16/2022,NC,2123905,1786267,337638,35967,3130,20796,18276,2520,78,10,01/16/2022 12:00:00 AM,Agree,Agree
06/14/2020,NC,44159,44151,8,1346,2,1218,1218,0,21,0,06/14/2020 12:00:00 AM,Agree,Agree
06/03/2021,NC,989951,852194,137757,684,201,13505,11911,1594,12,0,06/03/2021 12:00:00 AM,Agree,Agree
08/23/2022,NC,3102808,2572119,530689,3078,852,26430,22974,3456,11,1,08/23/2022 12:00:00 AM,Agree,Agree
08/26/2020,NC,161833,159371,2462,1405,106,2843,2833,10,30,0,08/26/2020 12:00:00 AM,Agree,Agree
08/06/2020,NC,132187,130977,1210,1940,60,2279,2275,4,25,0,08/06/2020 12:00:00 AM,Agree,Agree
02/01/2020,NC,0,,,0,,0,,,0,,03/26/2020 04:22:39 PM,Agree,Agree
05/27/2022,NC,2757518,2302511,455007,4757,967,25294,22051,3243,8,2,05/27/2022 12:00:00 AM,Agree,Agree
12/17/2020,NC,463948,428429,35519,7234,977,6853,6458,395,84,26,12/17/2020 12:00:00 AM,Agree,Agree
06/18/2020,NC,48413,48405,8,1367,0,1271,1271,0,13,0,06/18/2020 12:00:00 AM,Agree,Agree
08/19/2022,NC,3091796,2563460,528336,3883,818,26367,22923,3444,10,2,08/19/2022 12:00:00 AM,Agree,Agree
02/26/2020,NC,0,,,0,,0,,,0,,03/26/2020 04:22:39 PM,Agree,Agree
08/09/2021,NC,1078007,921767,156240,3013,320,14023,12359,1664,18,1,08/09/2021 12:00:00 AM,Agree,Agree
04/04/2022,NC,2633313,2202961,430352,269,38,24951,21760,3191,3,0,04/04/2022 12:00:00 AM,Agree,Agree
02/05/2020,NC,0,,,0,,0,,,0,,03/26/2020 04:22:39 PM,Agree,Agree
09/24/2020,NC,202140,197426,4714,1801,114,3657,3619,38,25,1,09/24/2020 12:00:00 AM,Agree,Agree
08/13/2020,NC,142384,140800,1584,1767,100,2494,2489,5,32,0,08/13/2020 12:00:00 AM,Agree,Agree
04/03/2022,NC,2633044,2202730,430314,384,65,24948,21757,3191,9,0,04/03/2022 12:00:00 AM,Agree,Agree
06/05/2021,NC,991071,853001,138070,517,165,13516,11918,1598,6,3,06/05/2021 12:00:00 AM,Agree,Agree
10/30/2021,NC,1469368,1246661,222707,1818,323,18467,16247,2220,28,2,10/30/2021 12:00:00 AM,Agree,Agree
07/09/2020,NC,79676,79530,146,1993,14,1591,1590,1,17,1,07/09/2020 12:00:00 AM,Agree,Agree
01/10/2021,NC,631788,571746,60042,7989,613,8903,8121,782,93,10,01/10/2021 12:00:00 AM,Agree,Agree
07/07/2020,NC,76106,75996,110,1369,21,1560,1560,0,19,0,07/07/2020 12:00:00 AM,Agree,Agree
08/03/2022,NC,3026867,2512573,514294,5335,1412,26130,22722,3408,13,2,08/03/2022 12:00:00 AM,Agree,Agree
06/21/2021,NC,997177,857524,139653,209,47,13607,11996,1611,8,2,06/21/2021 12:00:00 AM,Agree,Agree
08/20/2020,NC,152464,150446,2018,2062,73,2690,2683,7,26,0,08/20/2020 12:00:00 AM,Agree,Agree
06/09/2020,NC,37569,37563,6,828,1,1148,1148,0,21,0,06/09/2020 12:00:00 AM,Agree,Agree
02/14/2022,NC,2571586,2156146,415440,2673,338,23528,20536,2992,81,11,02/14/2022 12:00:00 AM,Agree,Agree
09/13/2020,NC,187740,184067,3673,1102,26,3343,3319,24,21,1,09/13/2020 12:00:00 AM,Agree,Agree
04/29/2021,NC,955342,825907,129435,2243,459,13104,11573,1531,9,2,04/29/2021 12:00:00 AM,Agree,Agree
02/03/2021,NC,776731,688638,88093,4581,1121,11212,9971,1241,64,12,02/03/2021 12:00:00 AM,Agree,Agree
03/11/2020,NC,7,7,0,0,0,0,0,0,0,0,03/11/2020 12:00:00 AM,Agree,Agree
05/25/2021,NC,984613,848214,136399,711,223,13423,11836,1587,8,2,05/25/2021 12:00:00 AM,Agree,Agree
02/01/2021,NC,761615,680845,80770,2734,354,11055,9841,1214,85,18,02/01/2021 12:00:00 AM,Agree,Agree
08/13/2022,NC,3071697,2547821,523876,4410,986,26278,22849,3429,18,4,08/13/2022 12:00:00 AM,Agree,Agree
02/24/2022,NC,2602849,2179665,423184,2533,551,24123,21038,3085,50,5,02/24/2022 12:00:00 AM,Agree,Agree
09/21/2022,NC,3188668,2636772,551896,2923,812,26787,23279,3508,11,1,09/21/2022 12:00:00 AM,Agree,Agree
05/25/2022,NC,2747775,2294724,453051,4955,1174,25273,22033,3240,13,3,05/25/2022 12:00:00 AM,Agree,Agree
05/30/2020,NC,27781,27780,1,1059,0,969,969,0,20,0,05/30/2020 12:00:00 AM,Agree,Agree
09/26/2021,NC,1375588,1170560,205028,4208,391,16934,14889,2045,69,6,09/26/2021 12:00:00 AM,Agree,Agree
08/09/2020,NC,137150,135832,1318,1358,13,2365,2360,5,22,0,08/09/2020 12:00:00 AM,Agree,Agree
04/28/2020,NC,9782,9782,0,447,0,399,399,0,15,0,04/28/2020 12:00:00 AM,Agree,Agree
05/19/2021,NC,979740,844607,135133,1148,289,13355,11778,1577,13,1,05/19/2021 12:00:00 AM,Agree,Agree
10/13/2021,NC,1433565,1218153,215412,3122,657,17863,15705,2158,55,4,10/13/2021 12:00:00 AM,Agree,Agree
09/12/2020,NC,186638,182991,3647,1489,77,3322,3299,23,28,1,09/12/2020 12:00:00 AM,Agree,Agree
12/09/2020,NC,414806,386242,28564,5965,813,6282,5995,287,58,9,12/09/2020 12:00:00 AM,Agree,Agree
04/11/2022,NC,2638175,2206855,431320,507,73,24998,21806,3192,4,0,04/11/2022 12:00:00 AM,Agree,Agree
06/24/2020,NC,56178,56162,16,1287,3,1363,1363,0,18,0,06/24/2020 12:00:00 AM,Agree,Agree
12/07/2021,NC,1544708,1306183,238525,2666,771,19200,16900,2300,21,1,12/07/2021 12:00:00 AM,Agree,Agree
08/03/2020,NC,127460,126450,1010,1356,18,2197,2194,3,25,0,08/03/2020 12:00:00 AM,Agree,Agree
10/03/2020,NC,216557,210599,5958,2001,183,3891,3845,46,19,1,10/03/2020 12:00:00 AM,Agree,Agree
09/22/2022,NC,3191425,2638800,552625,2757,729,26798,23287,3511,11,3,09/22/2022 12:00:00 AM,Agree,Agree
09/28/2021,NC,1382248,1176033,206215,3972,961,17058,15003,2055,60,6,09/28/2021 12:00:00 AM,Agree,Agree
05/03/2020,NC,11919,11919,0,339,0,477,477,0,13,0,05/03/2020 12:00:00 AM,Agree,Agree
04/26/2020,NC,8924,8924,0,295,0,360,360,0,21,0,10/05/2022 12:29:35 PM,Agree,Agree
09/03/2020,NC,174961,171907,3054,1971,89,3076,3062,14,36,2,09/03/2020 12:00:00 AM,Agree,Agree
06/23/2020,NC,54891,54878,13,1017,1,1345,1345,0,9,0,06/23/2020 12:00:00 AM,Agree,Agree
12/29/2021,NC,1650926,1392306,258620,15056,3014,19773,17405,2368,33,5,12/29/2021 12:00:00 AM,Agree,Agree
11/13/2020,NC,306805,291690,15115,3779,493,5194,5045,149,37,7,11/13/2020 12:00:00 AM,Agree,Agree
08/25/2021,NC,1169979,997624,172355,7940,1616,14703,12936,1767,55,6,08/25/2021 12:00:00 AM,Agree,Agree
10/22/2021,NC,1454784,1235048,219736,2249,487,18222,16025,2197,29,1,10/22/2021 12:00:00 AM,Agree,Agree
12/02/2021,NC,1530473,1294817,235656,3854,820,19099,16812,2287,19,7,12/02/2021 12:00:00 AM,Agree,Agree
08/21/2020,NC,154458,152362,2096,1994,78,2706,2699,7,16,0,08/21/2020 12:00:00 AM,Agree,Agree
09/09/2022,NC,3156040,2612167,543873,3913,981,26643,23154,3489,12,0,09/09/2022 12:00:00 AM,Agree,Agree
07/13/2020,NC,87697,87498,199,1808,3,1671,1670,1,27,0,07/13/2020 12:00:00 AM,Agree,Agree
02/11/2021,NC,808413,714244,94169,4236,767,11696,10364,1332,62,12,02/11/2021 12:00:00 AM,Agree,Agree
08/25/2022,NC,3110704,2577983,532721,4030,995,26460,23001,3459,14,2,08/25/2022 12:00:00 AM,Agree,Agree
04/12/2021,NC,923655,801829,121826,1257,274,12909,11407,1502,12,0,04/12/2021 12:00:00 AM,Agree,Agree
02/21/2022,NC,2595443,2174188,421255,1505,288,23975,20908,3067,54,11,02/21/2022 12:00:00 AM,Agree,Agree
09/23/2020,NC,200339,195739,4600,1147,144,3632,3595,37,29,0,09/23/2020 12:00:00 AM,Agree,Agree
09/20/2022,NC,3185745,2634661,551084,2448,681,26776,23269,3507,11,0,09/20/2022 12:00:00 AM,Agree,Agree
07/30/2022,NC,3010439,2499760,510679,5450,1325,26071,22670,3401,12,3,07/30/2022 12:00:00 AM,Agree,Agree
02/25/2021,NC,846271,743586,102685,2879,611,12243,10824,1419,28,7,02/25/2021 12:00:00 AM,Agree,Agree
04/24/2020,NC,8196,8196,0,470,0,323,323,0,17,0,10/05/2022 12:29:35 PM,Agree,Agree
04/20/2021,NC,938860,813456,125404,1564,437,12995,11480,1515,13,2,04/20/2021 12:00:00 AM,Agree,Agree
03/14/2021,NC,875773,765872,109901,1328,251,12568,11111,1457,14,1,03/14/2021 12:00:00 AM,Agree,Agree
03/07/2021,NC,864797,757940,106857,1309,260,12461,11017,1444,21,5,03/07/2021 12:00:00 AM,Agree,Agree
03/15/2022,NC,2622767,2194867,427900,507,174,24705,21538,3167,16,4,03/15/2022 12:00:00 AM,Agree,Agree
04/17/2021,NC,934580,810192,124388,2167,443,12958,11450,1508,16,1,04/17/2021 12:00:00 AM,Agree,Agree
02/14/2020,NC,0,,,0,,0,,,0,,03/26/2020 04:22:39 PM,Agree,Agree
11/12/2021,NC,1490346,1263221,227125,1913,326,18745,16505,2240,22,1,11/12/2021 12:00:00 AM,Agree,Agree
09/03/2022,NC,3139206,2599695,539511,3205,759,26577,23096,3481,11,3,09/03/2022 12:00:00 AM,Agree,Agree
11/14/2020,NC,310181,294628,15553,3376,438,5234,5082,152,40,3,11/14/2020 12:00:00 AM,Agree,Agree
05/29/2021,NC,987777,850593,137184,679,141,13458,11868,1590,8,2,05/29/2021 12:00:00 AM,Agree,Agree
12/29/2020,NC,529009,483963,45046,4894,1424,7749,7191,558,102,14,12/29/2020 12:00:00 AM,Agree,Agree
03/22/2021,NC,888241,775250,112991,893,173,12676,11207,1469,9,1,03/22/2021 12:00:00 AM,Agree,Agree
09/18/2020,NC,194427,190258,4169,1562,103,3500,3467,33,33,2,09/18/2020 12:00:00 AM,Agree,Agree
01/02/2022,NC,1725723,1454613,271110,11967,1759,19887,17500,2387,34,5,01/02/2022 12:00:00 AM,Agree,Agree
01/09/2021,NC,623799,564370,59429,9497,1122,8810,8038,772,95,20,01/09/2021 12:00:00 AM,Agree,Agree
12/26/2021,NC,1624311,1370729,253582,4865,437,19683,17329,2354,28,6,12/26/2021 12:00:00 AM,Agree,Agree
02/10/2021,NC,804177,710775,93402,3749,866,11634,10314,1320,63,17,02/10/2021 12:00:00 AM,Agree,Agree
07/01/2020,NC,66840,66791,49,1873,8,1470,1470,0,22,0,07/01/2020 12:00:00 AM,Agree,Agree
01/04/2021,NC,576042,524457,51585,4753,625,8289,7629,660,83,18,01/04/2021 12:00:00 AM,Agree,Agree
03/21/2020,NC,209,209,0,56,0,1,1,0,0,0,03/21/2020 12:00:00 AM,Agree,Agree
03/01/2020,NC,0,,,0,,0,,,0,,03/26/2020 04:22:39 PM,Agree,Agree
11/18/2020,NC,322558,305642,16916,3711,533,5380,5219,161,39,1,11/18/2020 12:00:00 AM,Agree,Agree
08/12/2020,NC,140617,139133,1484,1357,85,2462,2457,5,29,0,08/12/2020 12:00:00 AM,Agree,Agree
04/16/2020,NC,5483,5483,0,294,0,181,181,0,23,0,04/16/2020 12:00:00 AM,Agree,Agree
08/14/2021,NC,1106530,944690,161840,5866,1002,14173,12485,1688,31,6,08/14/2021 12:00:00 AM,Agree,Agree
04/23/2022,NC,2653866,2219452,434414,1709,334,25062,21857,3205,4,1,04/23/2022 12:00:00 AM,Agree,Agree
06/24/2021,NC,998421,858341,140080,434,124,13615,12003,1612,1,0,06/24/2021 12:00:00 AM,Agree,Agree
02/02/2021,NC,772150,685178,86972,10535,6202,11148,9919,1229,93,15,02/02/2021 12:00:00 AM,Agree,Agree
05/09/2022,NC,2687064,2246062,441002,1639,244,25157,21937,3220,8,1,05/09/2022 12:00:00 AM,Agree,Agree
04/30/2021,NC,957322,827438,129884,1980,449,13118,11586,1532,14,1,04/30/2021 12:00:00 AM,Agree,Agree
05/10/2020,NC,14997,14997,0,484,0,600,600,0,11,0,05/10/2020 12:00:00 AM,Agree,Agree
09/04/2022,NC,3141520,2601535,539985,2314,474,26590,23107,3483,13,2,09/04/2022 12:00:00 AM,Agree,Agree
09/30/2021,NC,1391710,1183679,208031,5044,800,17188,15111,2077,60,7,09/30/2021 12:00:00 AM,Agree,Agree
05/02/2022,NC,2669491,2232111,437380,1262,186,25117,21903,3214,7,1,05/02/2022 12:00:00 AM,Agree,Agree
09/02/2021,NC,1228152,1046541,181611,8782,1515,15225,13395,1830,69,6,09/02/2021 12:00:00 AM,Agree,Agree
12/05/2020,NC,393177,367106,26071,6152,872,6073,5820,253,49,3,12/05/2020 12:00:00 AM,Agree,Agree
04/09/2021,NC,918737,798010,120727,2283,589,12870,11373,1497,8,0,04/09/2021 12:00:00 AM,Agree,Agree
04/15/2022,NC,2643128,2210720,432408,1462,302,25026,21828,3198,6,0,04/15/2022 12:00:00 AM,Agree,Agree
09/08/2022,NC,3152127,2609235,542892,4386,1261,26631,23142,3489,10,1,09/08/2022 12:00:00 AM,Agree,Agree
03/23/2021,NC,889750,776174,113576,1509,585,12685,11214,1471,9,2,03/23/2021 12:00:00 AM,Agree,Agree
02/12/2022,NC,2564879,2150549,414330,5985,1314,23358,20392,2966,86,12,02/12/2022 12:00:00 AM,Agree,Agree
04/25/2020,NC,8629,8629,0,433,0,339,339,0,16,0,10/05/2022 12:29:35 PM,Agree,Agree
01/26/2020,NC,0,,,0,,0,,,0,,03/26/2020 04:22:39 PM,Agree,Agree
09/08/2020,NC,181120,177846,3274,823,22,3214,3196,18,32,1,09/08/2020 12:00:00 AM,Agree,Agree
04/19/2020,NC,6523,6523,0,354,0,240,240,0,19,0,04/19/2020 12:00:00 AM,Agree,Agree
02/12/2020,NC,0,,,0,,0,,,0,,03/26/2020 04:22:39 PM,Agree,Agree
11/16/2020,NC,315173,299324,15849,2219,129,5304,5148,156,36,2,11/16/2020 12:00:00 AM,Agree,Agree
08/09/2022,NC,3052676,2533049,519627,3726,1055,26215,22797,3418,14,3,08/09/2022 12:00:00 AM,Agree,Agree
05/19/2020,NC,19665,19665,0,517,0,732,732,0,12,0,05/19/2020 12:00:00 AM,Agree,Agree
04/29/2020,NC,10139,10139,0,357,0,414,414,0,15,0,04/29/2020 12:00:00 AM,Agree,Agree
04/10/2022,NC,2637668,2206421,431247,707,93,24994,21802,3192,6,0,04/10/2022 12:00:00 AM,Agree,Agree
04/14/2020,NC,5018,5018,0,185,0,142,142,0,17,0,04/14/2020 12:00:00 AM,Agree,Agree
06/01/2022,NC,2772894,2314681,458213,3023,1035,25345,22091,3254,15,4,06/01/2022 12:00:00 AM,Agree,Agree
04/19/2022,NC,2646912,2213891,433021,939,178,25049,21848,3201,5,2,04/19/2022 12:00:00 AM,Agree,Agree
12/03/2021,NC,1534259,1297833,236426,3786,770,19116,16827,2289,17,2,12/03/2021 12:00:00 AM,Agree,Agree
06/27/2020,NC,60886,60851,35,1747,7,1407,1407,0,15,0,06/27/2020 12:00:00 AM,Agree,Agree
07/25/2022,NC,2982344,2478919,503425,3164,439,26005,22621,3384,14,2,07/25/2022 12:00:00 AM,Agree,Agree
03/12/2021,NC,872642,763578,109064,1713,420,12540,11084,1456,10,2,03/12/2021 12:00:00 AM,Agree,Agree
06/18/2021,NC,996228,856808,139420,468,137,13592,11984,1608,3,0,06/18/2021 12:00:00 AM,Agree,Agree
12/22/2021,NC,1598280,1348570,249710,5277,1043,19561,17224,2337,33,1,12/22/2021 12:00:00 AM,Agree,Agree
05/02/2020,NC,11580,11580,0,467,0,464,464,0,17,0,05/02/2020 12:00:00 AM,Agree,Agree
09/19/2022,NC,3183297,2632894,550403,1439,202,26765,23258,3507,13,2,09/19/2022 12:00:00 AM,Agree,Agree
01/02/2021,NC,564741,514414,50327,6438,537,8123,7501,622,116,18,01/02/2021 12:00:00 AM,Agree,Agree
02/22/2020,NC,0,,,0,,0,,,0,,03/26/2020 04:22:39 PM,Agree,Agree
06/14/2021,NC,994506,855585,138921,202,38,13574,11970,1604,6,0,06/14/2021 12:00:00 AM,Agree,Agree
04/02/2020,NC,1855,1855,0,276,0,25,25,0,9,0,04/02/2020 12:00:00 AM,Agree,Agree
12/05/2021,NC,1540023,1302545,237478,2504,378,19159,16863,2296,22,3,12/05/2021 12:00:00 AM,Agree,Agree
04/05/2020,NC,2636,2636,0,257,0,50,50,0,11,0,04/05/2020 12:00:00 AM,Agree,Agree
04/11/2020,NC,4229,4229,0,236,0,98,98,0,7,0,04/11/2020 12:00:00 AM,Agree,Agree
09/04/2020,NC,176659,173531,3128,1698,74,3103,3088,15,27,1,09/04/2020 12:00:00 AM,Agree,Agree
01/30/2020,NC,0,,,0,,0,,,0,,03/26/2020 04:22:39 PM,Agree,Agree
01/06/2021,NC,592714,537268,55446,8841,1923,8510,7798,712,92,24,01/06/2021 12:00:00 AM,Agree,Agree
05/18/2020,NC,19148,19148,0,409,0,720,720,0,15,0,05/18/2020 12:00:00 AM,Agree,Agree
07/08/2020,NC,77683,77551,132,1577,22,1574,1574,0,14,0,07/08/2020 12:00:00 AM,Agree,Agree
10/08/2020,NC,224822,218089,6733,2311,224,4025,3971,54,26,0,10/08/2020 12:00:00 AM,Agree,Agree
09/08/2021,NC,1265444,1078320,187124,5371,1520,15660,13777,1883,69,10,09/08/2021 12:00:00 AM,Agree,Agree
09/25/2022,NC,3197909,2643703,554206,1487,293,26823,23304,3519,7,3,09/25/2022 12:00:00 AM,Agree,Agree
03/15/2020,NC,32,32,0,10,0,1,1,0,0,0,03/15/2020 12:00:00 AM,Agree,Agree
05/10/2021,NC,970665,837723,132942,662,166,13235,11678,1557,5,3,05/10/2021 12:00:00 AM,Agree,Agree
07/06/2020,NC,74737,74648,89,1425,2,1541,1541,0,19,0,07/06/2020 12:00:00 AM,Agree,Agree
01/16/2021,NC,675207,608353,66854,7236,1077,9538,8629,909,129,22,01/16/2021 12:00:00 AM,Agree,Agree
06/06/2021,NC,991439,853302,138137,368,67,13522,11924,1598,6,0,06/06/2021 12:00:00 AM,Agree,Agree
01/08/2022,NC,1873505,1575686,297819,32486,5110,20225,17783,2442,68,10,01/08/2022 12:00:00 AM,Agree,Agree
02/15/2021,NC,820105,723946,96159,1911,314,11885,10526,1359,42,5,02/15/2021 12:00:00 AM,Agree,Agree
08/05/2020,NC,130247,129097,1150,1232,63,2254,2250,4,33,1,08/05/2020 12:00:00 AM,Agree,Agree
06/06/2022,NC,2793572,2331508,462064,2262,334,25392,22132,3260,5,2,06/06/2022 12:00:00 AM,Agree,Agree
12/06/2020,NC,398706,372316,26390,5529,319,6123,5864,259,50,6,12/06/2020 12:00:00 AM,Agree,Agree
06/11/2022,NC,2813487,2347097,466390,3951,820,25453,22177,3276,17,7,06/11/2022 12:00:00 AM,Agree,Agree
06/25/2021,NC,998841,858609,140232,420,152,13626,12013,1613,11,1,06/25/2021 12:00:00 AM,Agree,Agree
07/07/2022,NC,2901786,2416030,485756,4820,1352,25761,22427,3334,16,3,07/07/2022 12:00:00 AM,Agree,Agree
01/03/2021,NC,571289,520329,50960,6548,633,8206,7564,642,83,20,01/03/2021 12:00:00 AM,Agree,Agree
01/26/2022,NC,2372781,1994320,378461,22863,5218,21715,19046,2669,122,23,01/26/2022 12:00:00 AM,Agree,Agree
05/11/2022,NC,2693272,2250950,442322,3727,700,25174,21951,3223,7,2,05/11/2022 12:00:00 AM,Agree,Agree
12/08/2020,NC,408841,381090,27751,5886,1077,6224,5946,278,50,8,12/08/2020 12:00:00 AM,Agree,Agree
07/19/2022,NC,2952450,2455405,497045,4302,1313,25916,22548,3368,19,3,07/19/2022 12:00:00 AM,Agree,Agree
06/07/2022,NC,2796692,2333802,462890,3120,826,25402,22141,3261,10,1,06/07/2022 12:00:00 AM,Agree,Agree
08/11/2021,NC,1087870,929328,158542,5482,1213,14074,12403,1671,32,7,08/11/2021 12:00:00 AM,Agree,Agree
01/28/2020,NC,0,,,0,,0,,,0,,03/26/2020 04:22:39 PM,Agree,Agree
12/17/2021,NC,1578851,1332968,245883,4045,892,19434,17108,2326,26,1,12/17/2021 12:00:00 AM,Agree,Agree
10/27/2020,NC,263514,253063,10451,2045,253,4581,4482,99,30,3,10/27/2020 12:00:00 AM,Agree,Agree
10/20/2020,NC,248304,239342,8962,1719,279,4363,4285,78,41,1,10/20/2020 12:00:00 AM,Agree,Agree
11/02/2021,NC,1473056,1249631,223425,1460,409,18542,16320,2222,25,1,11/02/2021 12:00:00 AM,Agree,Agree
09/16/2022,NC,3176891,2627926,548965,3221,789,26736,23232,3504,6,1,09/16/2022 12:00:00 AM,Agree,Agree
09/06/2020,NC,179479,176244,3235,1155,25,3155,3139,16,28,0,09/06/2020 12:00:00 AM,Agree,Agree
10/12/2020,NC,232054,224800,7254,1340,56,4131,4069,62,22,1,10/12/2020 12:00:00 AM,Agree,Agree
05/21/2021,NC,981777,846169,135608,969,219,13388,11806,1582,15,2,05/21/2021 12:00:00 AM,Agree,Agree
07/27/2020,NC,114833,114191,642,1569,22,1987,1985,2,21,0,07/27/2020 12:00:00 AM,Agree,Agree
09/11/2022,NC,3162028,2616861,545167,2389,429,26671,23180,3491,10,2,09/11/2022 12:00:00 AM,Agree,Agree
05/15/2022,NC,2708370,2263345,445025,3269,456,25196,21967,3229,5,1,05/15/2022 12:00:00 AM,Agree,Agree
09/25/2021,NC,1371380,1166743,204637,5279,882,16865,14826,2039,66,14,09/25/2021 12:00:00 AM,Agree,Agree
04/21/2021,NC,940851,814943,125908,1991,504,13005,11489,1516,10,1,04/21/2021 12:00:00 AM,Agree,Agree
05/23/2022,NC,2739409,2288468,450941,2438,334,25251,22016,3235,5,0,05/23/2022 12:00:00 AM,Agree,Agree
04/06/2020,NC,2888,2888,0,252,0,59,59,0,9,0,04/06/2020 12:00:00 AM,Agree,Agree
10/21/2021,NC,1452535,1233286,219249,2443,519,18193,15997,2196,33,4,10/21/2021 12:00:00 AM,Agree,Agree
01/30/2022,NC,2451345,2060834,390511,11749,1336,22141,19392,2749,102,23,01/30/2022 12:00:00 AM,Agree,Agree
11/17/2021,NC,1498898,1270030,228868,2252,554,18821,16565,2256,20,5,11/17/2021 12:00:00 AM,Agree,Agree
04/16/2021,NC,932413,808468,123945,2303,459,12942,11435,1507,9,3,04/16/2021 12:00:00 AM,Agree,Agree
06/25/2020,NC,57535,57518,17,1357,1,1375,1375,0,12,0,06/25/2020 12:00:00 AM,Agree,Agree
04/04/2020,NC,2379,2379,0,286,0,39,39,0,11,0,04/04/2020 12:00:00 AM,Agree,Agree
12/20/2020,NC,483715,445622,38093,5641,482,7059,6622,437,64,13,12/20/2020 12:00:00 AM,Agree,Agree
04/28/2021,NC,953099,824123,128976,1769,493,13095,11566,1529,16,3,04/28/2021 12:00:00 AM,Agree,Agree
05/14/2022,NC,2705101,2260532,444569,3858,739,25191,21963,3228,2,0,05/14/2022 12:00:00 AM,Agree,Agree
09/13/2021,NC,1300597,1108032,192565,4804,391,16026,14097,1929,83,5,09/13/2021 12:00:00 AM,Agree,Agree
11/28/2021,NC,1519186,1286148,233038,1542,400,19037,16760,2277,28,0,11/28/2021 12:00:00 AM,Agree,Agree
04/26/2022,NC,2657703,2222596,435107,1550,356,25082,21872,3210,8,3,04/26/2022 12:00:00 AM,Agree,Agree
07/22/2021,NC,1019653,874035,145618,1913,452,13752,12124,1628,8,1,07/22/2021 12:00:00 AM,Agree,Agree
02/08/2020,NC,0,,,0,,0,,,0,,03/26/2020 04:22:39 PM,Agree,Agree
04/03/2020,NC,2093,2093,0,238,0,28,28,0,3,0,04/03/2020 12:00:00 AM,Agree,Agree
05/15/2020,NC,17522,17522,0,811,0,686,686,0,14,0,05/15/2020 12:00:00 AM,Agree,Agree
03/19/2021,NC,884146,772003,112143,1972,451,12634,11169,1465,18,3,03/19/2021 12:00:00 AM,Agree,Agree
07/30/2021,NC,1040318,890600,149718,3550,696,13845,12205,1640,10,1,07/30/2021 12:00:00 AM,Agree,Agree
06/22/2020,NC,53874,53862,12,1104,0,1336,1336,0,20,0,06/22/2020 12:00:00 AM,Agree,Agree
12/06/2021,NC,1542042,1304288,237754,2019,276,19179,16880,2299,20,3,12/06/2021 12:00:00 AM,Agree,Agree
02/27/2022,NC,2608951,2184419,424532,1247,210,24250,21147,3103,43,8,02/27/2022 12:00:00 AM,Agree,Agree
05/08/2022,NC,2685425,2244667,440758,2396,354,25149,21930,3219,3,0,05/08/2022 12:00:00 AM,Agree,Agree
02/13/2022,NC,2568913,2153811,415102,4034,772,23447,20466,2981,89,15,02/13/2022 12:00:00 AM,Agree,Agree
06/21/2022,NC,2844015,2371443,472572,2599,731,25552,22259,3293,6,0,06/21/2022 12:00:00 AM,Agree,Agree
07/02/2022,NC,2886670,2404444,482226,4116,971,25687,22366,3321,11,2,07/02/2022 12:00:00 AM,Agree,Agree
01/24/2021,NC,723378,648847,74531,5263,584,10352,9271,1081,90,22,01/24/2021 12:00:00 AM,Agree,Agree
12/19/2021,NC,1586375,1339113,247262,3408,466,19479,17147,2332,19,3,12/19/2021 12:00:00 AM,Agree,Agree
10/07/2020,NC,222511,216002,6509,1809,241,3999,3945,54,26,3,10/07/2020 12:00:00 AM,Agree,Agree
03/05/2022,NC,2616225,2189875,426350,1125,295,24445,21318,3127,28,2,03/05/2022 12:00:00 AM,Agree,Agree
06/13/2021,NC,994304,855421,138883,333,68,13568,11964,1604,4,0,06/13/2021 12:00:00 AM,Agree,Agree
09/15/2020,NC,189818,185986,3832,1265,133,3407,3378,29,40,3,09/15/2020 12:00:00 AM,Agree,Agree
07/19/2020,NC,99771,99403,368,1773,5,1787,1785,2,17,0,07/19/2020 12:00:00 AM,Agree,Agree
07/12/2020,NC,85889,85693,196,1987,6,1644,1643,1,17,0,07/12/2020 12:00:00 AM,Agree,Agree
01/31/2020,NC,0,,,0,,0,,,0,,03/26/2020 04:22:39 PM,Agree,Agree
08/17/2022,NC,3083995,2557364,526631,4021,1088,26339,22899,3440,13,2,08/17/2022 12:00:00 AM,Agree,Agree
07/16/2020,NC,93692,93402,290,2006,37,1725,1723,2,16,0,07/16/2020 12:00:00 AM,Agree,Agree
02/01/2022,NC,2468660,2074285,394375,9942,3053,22318,19537,2781,86,17,02/01/2022 12:00:00 AM,Agree,Agree
06/29/2021,NC,1000246,859621,140625,416,140,13641,12027,1614,2,0,06/29/2021 12:00:00 AM,Agree,Agree
11/17/2020,NC,318847,302464,16383,3674,534,5341,5181,160,37,4,11/17/2020 12:00:00 AM,Agree,Agree
07/30/2020,NC,120825,119995,830,2357,64,2069,2066,3,25,0,07/30/2020 12:00:00 AM,Agree,Agree
04/27/2022,NC,2660072,2224436,435636,2369,529,25094,21884,3210,12,0,04/27/2022 12:00:00 AM,Agree,Agree
06/11/2020,NC,39697,39691,6,1268,0,1173,1173,0,12,0,06/11/2020 12:00:00 AM,Agree,Agree
01/27/2021,NC,737189,659932,77257,5363,1133,10607,9468,1139,79,22,01/27/2021 12:00:00 AM,Agree,Agree
06/19/2021,NC,996645,857112,139533,417,113,13596,11988,1608,4,0,06/19/2021 12:00:00 AM,Agree,Agree
04/05/2022,NC,2633765,2203304,430461,452,109,24955,21764,3191,4,0,04/05/2022 12:00:00 AM,Agree,Agree
07/19/2021,NC,1014629,870282,144347,779,129,13730,12103,1627,2,0,07/19/2021 12:00:00 AM,Agree,Agree
08/04/2020,NC,129015,127928,1087,1555,77,2221,2218,3,24,0,08/04/2020 12:00:00 AM,Agree,Agree
06/23/2022,NC,2852402,2377866,474536,4421,1004,25580,22282,3298,10,0,06/23/2022 12:00:00 AM,Agree,Agree
09/26/2022,NC,3198974,2644599,554375,1065,169,26830,23310,3520,7,1,09/26/2022 12:00:00 AM,Agree,Agree
08/22/2020,NC,156218,154041,2177,1760,81,2733,2726,7,27,0,08/22/2020 12:00:00 AM,Agree,Agree
03/10/2020,NC,7,7,0,5,0,0,0,0,0,0,03/10/2020 12:00:00 AM,Agree,Agree
07/14/2022,NC,2932083,2439621,492462,4899,1081,25843,22486,3357,20,5,07/14/2022 12:00:00 AM,Agree,Agree
01/05/2021,NC,583873,530350,53523,7831,1938,8418,7730,688,129,28,01/05/2021 12:00:00 AM,Agree,Agree
11/08/2021,NC,1482817,1257418,225399,1003,109,18671,16435,2236,16,1,11/08/2021 12:00:00 AM,Agree,Agree
02/21/2021,NC,836713,736396,100317,2073,260,12110,10722,1388,35,6,02/21/2021 12:00:00 AM,Agree,Agree
05/01/2020,NC,11113,11113,0,408,0,447,447,0,14,0,05/01/2020 12:00:00 AM,Agree,Agree
11/09/2020,NC,294032,280559,13473,1596,84,5052,4920,132,38,2,11/09/2020 12:00:00 AM,Agree,Agree
03/09/2022,NC,2618992,2192021,426971,953,200,24580,21437,3143,37,4,03/09/2022 12:00:00 AM,Agree,Agree
05/13/2020,NC,16021,16021,0,431,0,658,658,0,18,0,05/13/2020 12:00:00 AM,Agree,Agree
02/27/2021,NC,850935,747275,103660,2114,469,12302,10878,1424,27,2,02/27/2021 12:00:00 AM,Agree,Agree
05/16/2022,NC,2710902,2265569,445333,2532,308,25206,21976,3230,10,1,05/16/2022 12:00:00 AM,Agree,Agree
05/21/2020,NC,20986,20985,1,812,1,766,766,0,15,0,05/21/2020 12:00:00 AM,Agree,Agree
03/07/2022,NC,2617312,2190790,426522,411,60,24507,21371,3136,29,3,03/07/2022 12:00:00 AM,Agree,Agree
10/17/2020,NC,243336,234815,8521,2163,213,4269,4197,72,29,2,10/17/2020 12:00:00 AM,Agree,Agree
03/21/2022,NC,2625800,2197283,428517,217,36,24818,21640,3178,17,1,03/21/2022 12:00:00 AM,Agree,Agree
10/29/2021,NC,1467550,1245166,222384,1998,402,18439,16221,2218,28,3,10/29/2021 12:00:00 AM,Agree,Agree
09/23/2021,NC,1360593,1157702,202891,6280,995,16722,14707,2015,65,9,09/23/2021 12:00:00 AM,Agree,Agree
12/24/2021,NC,1612550,1360411,252139,7299,1192,19625,17282,2343,28,4,12/24/2021 12:00:00 AM,Agree,Agree
01/24/2020,NC,0,,,0,,0,,,0,,03/26/2020 04:22:39 PM,Agree,Agree
07/02/2020,NC,68417,68350,67,1577,18,1481,1481,0,11,0,07/02/2020 12:00:00 AM,Agree,Agree
12/15/2020,NC,450603,417193,33410,5418,1229,6701,6342,359,81,18,12/15/2020 12:00:00 AM,Agree,Agree
09/25/2020,NC,203899,199051,4848,1759,134,3687,3648,39,30,1,09/25/2020 12:00:00 AM,Agree,Agree
09/02/2022,NC,3136001,2597249,538752,3604,891,26566,23088,3478,10,2,09/02/2022 12:00:00 AM,Agree,Agree
08/29/2021,NC,1200357,1023659,176698,6178,643,14944,13145,1799,58,11,08/29/2021 12:00:00 AM,Agree,Agree
07/09/2021,NC,1005452,863420,142032,718,181,13685,12067,1618,4,1,07/09/2021 12:00:00 AM,Agree,Agree
07/04/2020,NC,71910,71830,80,1444,3,1505,1505,0,12,0,07/04/2020 12:00:00 AM,Agree,Agree
02/16/2021,NC,822416,725480,96936,2311,777,11930,10568,1362,45,3,02/16/2021 12:00:00 AM,Agree,Agree
03/30/2022,NC,2630733,2200883,429850,536,151,24918,21730,3188,10,2,03/30/2022 12:00:00 AM,Agree,Agree
02/26/2022,NC,2607704,2183382,424322,1957,511,24207,21112,3095,45,5,02/26/2022 12:00:00 AM,Agree,Agree
12/30/2020,NC,537019,490197,46822,8010,1776,7832,7258,574,83,16,12/30/2020 12:00:00 AM,Agree,Agree
07/26/2022,NC,2986804,2482087,504717,4460,1292,26016,22628,3388,11,4,07/26/2022 12:00:00 AM,Agree,Agree
02/07/2021,NC,794487,703350,91137,3284,389,11447,10165,1282,54,12,02/07/2021 12:00:00 AM,Agree,Agree
07/27/2022,NC,2993352,2486618,506734,6548,2017,26028,22638,3390,12,2,07/27/2022 12:00:00 AM,Agree,Agree
01/22/2020,NC,0,,,0,,0,,,0,,03/26/2020 04:22:39 PM,Agree,Agree
03/24/2020,NC,423,423,0,98,0,2,2,0,0,0,03/24/2020 12:00:00 AM,Agree,Agree
10/08/2021,NC,1420476,1207331,213145,4252,680,17629,15501,2128,49,9,10/08/2021 12:00:00 AM,Agree,Agree
02/23/2022,NC,2600316,2177683,422633,2786,728,24073,20993,3080,47,4,02/23/2022 12:00:00 AM,Agree,Agree
02/12/2021,NC,812125,717231,94894,3712,725,11735,10395,1340,39,8,02/12/2021 12:00:00 AM,Agree,Agree
06/10/2021,NC,993037,854473,138564,481,138,13549,11948,1601,11,1,06/10/2021 12:00:00 AM,Agree,Agree
10/03/2021,NC,1403700,1193837,209863,2969,344,17365,15273,2092,68,5,10/03/2021 12:00:00 AM,Agree,Agree
02/16/2020,NC,0,,,0,,0,,,0,,03/26/2020 04:22:39 PM,Agree,Agree
06/30/2020,NC,64967,64926,41,1240,4,1448,1448,0,17,0,06/30/2020 12:00:00 AM,Agree,Agree
04/15/2021,NC,930110,806624,123486,2439,515,12933,11429,1504,5,0,04/15/2021 12:00:00 AM,Agree,Agree
03/02/2020,NC,0,,,0,,0,,,0,,03/26/2020 04:22:39 PM,Agree,Agree
06/20/2022,NC,2841416,2369575,471841,2099,293,25546,22253,3293,7,2,06/20/2022 12:00:00 AM,Agree,Agree
06/29/2020,NC,63727,63690,37,1313,1,1431,1431,0,12,0,06/29/2020 12:00:00 AM,Agree,Agree
08/08/2020,NC,135792,134487,1305,1757,30,2343,2338,5,40,1,08/08/2020 12:00:00 AM,Agree,Agree
02/21/2020,NC,0,,,0,,0,,,0,,03/26/2020 04:22:39 PM,Agree,Agree
12/14/2020,NC,445185,413004,32181,4156,379,6620,6279,341,57,7,12/14/2020 12:00:00 AM,Agree,Agree
03/26/2021,NC,895675,780697,114978,2060,474,12717,11243,1474,8,0,03/26/2021 12:00:00 AM,Agree,Agree
07/10/2021,NC,1006193,863965,142228,741,196,13691,12072,1619,6,1,07/10/2021 12:00:00 AM,Agree,Agree
03/23/2022,NC,2626970,2198124,428846,713,199,24847,21666,3181,13,3,03/23/2022 12:00:00 AM,Agree,Agree
09/05/2020,NC,178324,175114,3210,1665,82,3127,3111,16,24,1,09/05/2020 12:00:00 AM,Agree,Agree
03/08/2020,NC,2,2,0,0,0,0,0,0,0,0,03/08/2020 12:00:00 AM,Agree,Agree
08/24/2021,NC,1162039,991300,170739,5902,1435,14648,12887,1761,64,3,08/24/2021 12:00:00 AM,Agree,Agree
09/28/2022,NC,3203069,2647528,555541,2187,587,26841,23320,3521,5,1,09/28/2022 12:00:00 AM,Agree,Agree
01/15/2022,NC,2087938,1753430,334508,38212,5996,20718,18208,2510,88,12,01/15/2022 12:00:00 AM,Agree,Agree
09/27/2021,NC,1378276,1173022,205254,2688,226,16998,14949,2049,64,4,09/27/2021 12:00:00 AM,Agree,Agree
04/02/2021,NC,907471,789415,118056,1886,479,12799,11311,1488,11,2,04/02/2021 12:00:00 AM,Agree,Agree
09/20/2021,NC,1343444,1143831,199613,3702,288,16540,14546,1994,67,8,09/20/2021 12:00:00 AM,Agree,Agree
08/20/2022,NC,3095376,2566195,529181,3580,845,26386,22937,3449,19,5,08/20/2022 12:00:00 AM,Agree,Agree
07/15/2020,NC,91686,91433,253,1914,31,1709,1707,2,25,1,07/15/2020 12:00:00 AM,Agree,Agree
03/22/2020,NC,287,287,0,78,0,1,1,0,0,0,03/22/2020 12:00:00 AM,Agree,Agree
07/20/2022,NC,2958151,2459702,498449,5701,1404,25927,22558,3369,11,1,07/20/2022 12:00:00 AM,Agree,Agree
03/31/2022,NC,2631491,2201504,429987,758,137,24928,21739,3189,10,1,03/31/2022 12:00:00 AM,Agree,Agree
12/04/2021,NC,1537519,1300419,237100,3260,674,19137,16844,2293,21,4,12/04/2021 12:00:00 AM,Agree,Agree
07/05/2020,NC,73312,73225,87,1402,7,1522,1522,0,17,0,07/05/2020 12:00:00 AM,Agree,Agree
09/21/2020,NC,197945,193630,4315,821,20,3572,3536,36,28,1,09/21/2020 12:00:00 AM,Agree,Agree
01/30/2021,NC,754552,674565,79987,5811,909,10893,9708,1185,90,12,01/30/2021 12:00:00 AM,Agree,Agree
09/17/2022,NC,3179916,2630064,549852,3025,887,26742,23238,3504,6,0,09/17/2022 12:00:00 AM,Agree,Agree
02/05/2021,NC,786722,696791,89931,4468,842,11337,10075,1262,69,7,02/05/2021 12:00:00 AM,Agree,Agree
03/06/2022,NC,2616901,2190439,426462,676,112,24478,21345,3133,33,6,03/06/2022 12:00:00 AM,Agree,Agree
12/21/2021,NC,1593003,1344336,248667,3867,1000,19528,17192,2336,22,3,12/21/2021 12:00:00 AM,Agree,Agree
07/26/2020,NC,113264,112644,620,1787,17,1966,1964,2,23,0,07/26/2020 12:00:00 AM,Agree,Agree
12/14/2021,NC,1566801,1323596,243205,2922,775,19350,17030,2320,28,3,12/14/2021 12:00:00 AM,Agree,Agree
02/25/2020,NC,0,,,0,,0,,,0,,03/26/2020 04:22:39 PM,Agree,Agree
08/18/2021,NC,1125853,960775,165078,6085,1220,14348,12628,1720,57,7,08/18/2021 12:00:00 AM,Agree,Agree
09/29/2021,NC,1386666,1179435,207231,4418,1016,17128,15058,2070,70,15,09/29/2021 12:00:00 AM,Agree,Agree
06/16/2020,NC,46192,46184,8,952,0,1249,1249,0,8,0,06/16/2020 12:00:00 AM,Agree,Agree
11/14/2021,NC,1493736,1266014,227722,1745,225,18774,16528,2246,10,0,11/14/2021 12:00:00 AM,Agree,Agree
05/15/2021,NC,976496,842139,134357,1078,229,13301,11733,1568,11,1,05/15/2021 12:00:00 AM,Agree,Agree
09/07/2022,NC,3147741,2606110,541631,2728,963,26621,23133,3488,10,1,09/07/2022 12:00:00 AM,Agree,Agree
04/21/2020,NC,7033,7033,0,218,0,273,273,0,18,0,04/21/2020 12:00:00 AM,Agree,Agree
01/04/2022,NC,1755570,1479125,276445,17335,4121,19985,17581,2404,48,9,01/04/2022 12:00:00 AM,Agree,Agree
06/09/2022,NC,2805344,2340529,464815,4390,907,25423,22158,3265,10,1,06/09/2022 12:00:00 AM,Agree,Agree
06/30/2022,NC,2878064,2397793,480271,4579,1046,25666,22348,3318,11,5,06/30/2022 12:00:00 AM,Agree,Agree
05/14/2020,NC,16711,16711,0,690,0,672,672,0,14,0,05/14/2020 12:00:00 AM,Agree,Agree
08/12/2022,NC,3067287,2544397,522890,4499,966,26260,22835,3425,13,4,08/12/2022 12:00:00 AM,Agree,Agree
10/10/2021,NC,1426455,1212460,213995,2562,256,17724,15584,2140,37,4,10/10/2021 12:00:00 AM,Agree,Agree
01/25/2022,NC,2349918,1976675,373243,17766,5241,21593,18947,2646,111,19,01/25/2022 12:00:00 AM,Agree,Agree
07/04/2022,NC,2892112,2409067,483045,2283,354,25717,22392,3325,11,2,07/04/2022 12:00:00 AM,Agree,Agree
11/27/2021,NC,1517644,1285006,232638,1071,182,19009,16732,2277,18,3,11/27/2021 12:00:00 AM,Agree,Agree
11/01/2021,NC,1471596,1248580,223016,946,127,18517,16296,2221,22,1,11/01/2021 12:00:00 AM,Agree,Agree
09/19/2020,NC,195988,191721,4267,1561,98,3526,3492,34,26,1,09/19/2020 12:00:00 AM,Agree,Agree
08/02/2021,NC,1049073,897949,151124,2167,272,13890,12244,1646,13,2,08/02/2021 12:00:00 AM,Agree,Agree
12/23/2020,NC,500723,459640,41083,6869,1272,7278,6804,474,79,20,12/23/2020 12:00:00 AM,Agree,Agree
12/31/2021,NC,1692595,1426400,266195,21792,4063,19831,17450,2381,35,7,12/31/2021 12:00:00 AM,Agree,Agree
02/11/2020,NC,0,,,0,,0,,,0,,03/26/2020 04:22:39 PM,Agree,Agree
07/06/2021,NC,1003274,861878,141396,283,42,13669,12053,1616,2,0,07/06/2021 12:00:00 AM,Agree,Agree
09/27/2020,NC,206783,201782,5001,1256,32,3740,3698,42,26,2,09/27/2020 12:00:00 AM,Agree,Agree
03/27/2022,NC,2629403,2199907,429496,314,58,24888,21706,3182,10,1,03/27/2022 12:00:00 AM,Agree,Agree
04/14/2021,NC,927671,804700,122971,2117,601,12928,11424,1504,8,2,04/14/2021 12:00:00 AM,Agree,Agree
07/15/2021,NC,1010461,867091,143370,1102,288,13711,12089,1622,4,1,07/15/2021 12:00:00 AM,Agree,Agree
10/04/2020,NC,217988,211984,6004,1431,46,3918,3871,47,27,1,10/04/2020 12:00:00 AM,Agree,Agree
01/12/2021,NC,643343,581356,61987,5783,1493,9107,8281,826,113,26,01/12/2021 12:00:00 AM,Agree,Agree
05/18/2021,NC,978592,843748,134844,787,214,13342,11766,1576,9,1,05/18/2021 12:00:00 AM,Agree,Agree
06/01/2020,NC,29465,29464,1,779,0,1009,1009,0,21,0,06/01/2020 12:00:00 AM,Agree,Agree
01/14/2021,NC,658908,594317,64591,7935,1200,9308,8443,865,95,15,01/14/2021 12:00:00 AM,Agree,Agree
07/22/2020,NC,104798,104354,444,1813,50,1863,1861,2,25,0,07/22/2020 12:00:00 AM,Agree,Agree
02/20/2021,NC,834640,734583,100057,2512,569,12075,10693,1382,29,6,02/20/2021 12:00:00 AM,Agree,Agree
03/13/2020,NC,17,17,0,8,0,1,1,0,1,0,03/13/2020 12:00:00 AM,Agree,Agree
07/01/2022,NC,2882554,2401299,481255,4490,984,25676,22357,3319,10,1,07/01/2022 12:00:00 AM,Agree,Agree
02/19/2022,NC,2591582,2171029,420553,3286,795,23852,20806,3046,63,8,02/19/2022 12:00:00 AM,Agree,Agree
05/16/2020,NC,18258,18258,0,736,0,694,694,0,8,0,05/16/2020 12:00:00 AM,Agree,Agree
04/11/2021,NC,922398,800846,121552,1568,345,12897,11395,1502,14,3,04/11/2021 12:00:00 AM,Agree,Agree
03/18/2020,NC,62,62,0,23,0,1,1,0,0,0,03/18/2020 12:00:00 AM,Agree,Agree
05/14/2021,NC,975418,841290,134128,1143,244,13290,11723,1567,16,4,05/14/2021 12:00:00 AM,Agree,Agree
09/01/2020,NC,171665,168810,2855,1382,98,3009,2997,12,27,0,09/01/2020 12:00:00 AM,Agree,Agree
04/01/2022,NC,2632092,2201980,430112,601,125,24935,21745,3190,7,1,04/01/2022 12:00:00 AM,Agree,Agree
05/04/2022,NC,2674105,2235587,438518,2957,666,25133,21915,3218,8,2,05/04/2022 12:00:00 AM,Agree,Agree
08/28/2022,NC,3120103,2585395,534708,2414,374,26505,23039,3466,15,2,08/28/2022 12:00:00 AM,Agree,Agree
08/15/2020,NC,145563,143850,1713,1580,52,2534,2529,5,16,0,08/15/2020 12:00:00 AM,Agree,Agree
02/22/2022,NC,2597530,2175625,421905,2087,650,24026,20950,3076,51,9,02/22/2022 12:00:00 AM,Agree,Agree
10/24/2021,NC,1458298,1237923,220375,1586,215,18291,16087,2204,33,4,10/24/2021 12:00:00 AM,Agree,Agree
02/04/2020,NC,0,,,0,,0,,,0,,03/26/2020 04:22:39 PM,Agree,Agree
09/12/2022,NC,3163762,2618282,545480,1734,313,26683,23190,3493,12,2,09/12/2022 12:00:00 AM,Agree,Agree
01/22/2021,NC,711453,638523,72930,6818,1152,10170,9131,1039,98,18,01/22/2021 12:00:00 AM,Agree,Agree
02/07/2022,NC,2528724,2122791,405933,4387,539,22909,20018,2891,91,16,02/07/2022 12:00:00 AM,Agree,Agree
05/17/2022,NC,2713799,2267661,446138,2897,805,25217,21986,3231,11,1,05/17/2022 12:00:00 AM,Agree,Agree
06/12/2020,NC,41320,41314,6,1623,0,1185,1185,0,12,0,06/12/2020 12:00:00 AM,Agree,Agree
09/17/2020,NC,192865,188799,4066,1659,108,3467,3436,31,37,2,09/17/2020 12:00:00 AM,Agree,Agree
01/20/2021,NC,697540,626789,70751,6458,1327,9959,8960,999,124,29,01/20/2021 12:00:00 AM,Agree,Agree
10/10/2020,NC,229140,222007,7133,2174,186,4081,4025,56,30,1,10/10/2020 12:00:00 AM,Agree,Agree
02/27/2020,NC,0,,,0,,0,,,0,,03/26/2020 04:22:39 PM,Agree,Agree
11/20/2020,NC,331070,313248,17822,4144,431,5452,5286,166,37,4,11/20/2020 12:00:00 AM,Agree,Agree
08/18/2020,NC,149046,147179,1867,1269,91,2624,2617,7,32,1,08/18/2020 12:00:00 AM,Agree,Agree
10/09/2020,NC,226966,220019,6947,2144,214,4051,3996,55,26,1,10/09/2020 12:00:00 AM,Agree,Agree
11/21/2020,NC,334932,316630,18302,3862,480,5498,5325,173,46,7,11/21/2020 12:00:00 AM,Agree,Agree
05/22/2022,NC,2736971,2286364,450607,3570,518,25246,22011,3235,6,1,05/22/2022 12:00:00 AM,Agree,Agree
03/01/2021,NC,853690,749588,104102,1031,204,12344,10915,1429,21,4,03/01/2021 12:00:00 AM,Agree,Agree
10/29/2020,NC,268659,257682,10977,2817,250,4659,4556,103,50,4,10/29/2020 12:00:00 AM,Agree,Agree
02/28/2020,NC,0,,,0,,0,,,0,,03/26/2020 04:22:39 PM,Agree,Agree
07/27/2021,NC,1029991,882394,147597,2526,618,13808,12173,1635,15,1,07/27/2021 12:00:00 AM,Agree,Agree
10/13/2020,NC,233839,226346,7493,1785,239,4154,4092,62,23,0,10/13/2020 12:00:00 AM,Agree,Agree
04/23/2020,NC,7726,7726,0,396,0,306,306,0,13,0,10/05/2022 12:29:35 PM,Agree,Agree
11/13/2021,NC,1491991,1264494,227497,1645,372,18764,16518,2246,19,6,11/13/2021 12:00:00 AM,Agree,Agree
02/09/2020,NC,0,,,0,,0,,,0,,03/26/2020 04:22:39 PM,Agree,Agree
05/05/2020,NC,12474,12474,0,316,0,514,514,0,18,0,05/05/2020 12:00:00 AM,Agree,Agree
04/02/2022,NC,2632660,2202411,430249,568,137,24939,21748,3191,4,1,04/02/2022 12:00:00 AM,Agree,Agree
10/02/2022,NC,3210000,2653019,556981,1017,174,26852,23331,3521,2,0,10/02/2022 12:00:00 AM,Agree,Agree
01/31/2022,NC,2458718,2067396,391322,7373,811,22232,19468,2764,91,15,01/31/2022 12:00:00 AM,Agree,Agree
11/26/2021,NC,1516573,1284117,232456,1566,228,18991,16717,2274,20,3,11/26/2021 12:00:00 AM,Agree,Agree
12/13/2020,NC,441029,409227,31802,5418,509,6563,6229,334,80,10,12/13/2020 12:00:00 AM,Agree,Agree
02/18/2022,NC,2588296,2168538,419758,3984,888,23789,20751,3038,63,9,02/18/2022 12:00:00 AM,Agree,Agree
10/26/2021,NC,1461090,1240091,220999,1620,464,18353,16147,2206,29,2,10/26/2021 12:00:00 AM,Agree,Agree
07/13/2021,NC,1008294,865546,142748,886,240,13701,12081,1620,3,0,07/13/2021 12:00:00 AM,Agree,Agree
01/23/2020,NC,0,,,0,,0,,,0,,03/26/2020 04:22:39 PM,Agree,Agree
10/05/2020,NC,219314,213275,6039,1326,35,3946,3898,48,28,1,10/05/2020 12:00:00 AM,Agree,Agree
03/27/2021,NC,897565,782132,115433,1890,455,12729,11253,1476,12,2,03/27/2021 12:00:00 AM,Agree,Agree
02/15/2020,NC,0,,,0,,0,,,0,,03/26/2020 04:22:39 PM,Agree,Agree
04/22/2022,NC,2652157,2218077,434080,1869,365,25058,21854,3204,2,1,04/22/2022 12:00:00 AM,Agree,Agree
12/09/2021,NC,1552185,1311862,240323,4182,950,19242,16938,2304,27,4,12/09/2021 12:00:00 AM,Agree,Agree
10/23/2020,NC,255527,245741,9786,2654,297,4459,4374,85,28,1,10/23/2020 12:00:00 AM,Agree,Agree
03/29/2020,NC,1105,1105,0,141,0,7,7,0,1,0,03/29/2020 12:00:00 AM,Agree,Agree
09/24/2021,NC,1366101,1162346,203755,5508,864,16799,14774,2025,77,10,09/24/2021 12:00:00 AM,Agree,Agree
12/26/2020,NC,517162,474504,42658,4035,132,7495,6975,520,74,13,12/26/2020 12:00:00 AM,Agree,Agree
01/27/2020,NC,0,,,0,,0,,,0,,03/26/2020 04:22:39 PM,Agree,Agree
10/09/2021,NC,1423893,1210154,213739,3417,594,17687,15551,2136,58,8,10/09/2021 12:00:00 AM,Agree,Agree
01/05/2022,NC,1779983,1498238,281745,24413,5300,20033,17622,2411,48,7,01/05/2022 12:00:00 AM,Agree,Agree
05/09/2020,NC,14513,14513,0,466,0,589,589,0,19,0,05/09/2020 12:00:00 AM,Agree,Agree
03/16/2022,NC,2623395,2195349,428046,628,146,24724,21555,3169,19,2,03/16/2022 12:00:00 AM,Agree,Agree
06/18/2022,NC,2836549,2365385,471164,3780,769,25531,22242,3289,14,4,06/18/2022 12:00:00 AM,Agree,Agree
04/30/2022,NC,2666712,2229779,436933,2158,396,25105,21894,3211,2,1,04/30/2022 12:00:00 AM,Agree,Agree
10/14/2020,NC,235902,228154,7748,2063,255,4190,4123,67,36,5,10/14/2020 12:00:00 AM,Agree,Agree
